的	白勹
一	一一
是	是丨
不	不一
了	了ㄋ
在	在土
我	我ノ
人	人ノ
他	亻也
这	文辶
有	⺝
个	人丨
大	大一
上	上丨
中	中丨
来	夹来
地	土也ㄋ
和	禾口
说	讠总
为	为丶
们	亻门
到	至刂
你	亻尔
就	京尢
也	也ㄋ
以	以ㄋ
国	囗王
那	阝
要	覀女
时	日寸
出	出ㄋ
着	目
可	可一
道	䒑自
之	之丶
对	又寸
会	人云
自	自ノ
而	而一
得	彳旦
下	下一
能	厶⺝
过	寸辶
生	生ノ
子	子ㄋ
于	于一
年	
后	同
发	发ㄋ
都	者阝
里	里丨
没	氵殳
还	不辶
所	
去	去一
看	目
事	同肀
如	女口
用	用ノ
小	小丨
作	亻乍
多	夕夕
行	彳亍
只	口八
好	女子
成	戊
家	宀豕
天	天一
她	女也
方	方丶
然	犬
当	彐
心	心丶
起	走己
种	禾中
想	相心
经	纟轻
现	王见
但	亻旦
法	氵去
无	一尢
同	冂同
么	丿厶
进	井辶
学	学子
面	丆囬
其	其一
前	前丶
已	已ㄋ
主	主丶
从	从ノ
动	云力
分	分ノ
把	扌巴
开	开一一
军	冖车
又	又ㄋ
两	丙从
本	木一
因	因丨
定	定丶
部	立口
与	与一
将	丬夕
日	日丨
长	长ノ
理	王里
三	三一
些	此二
实	宀⺀
样	木羊
十	十一丨
意	音心
知	矢口
此	此丨
第	弓
力	力ㄋ
很	彳艮
正	正一
高	高丶
手	手ノ
什	亻十一
身	身ノ
被	衤皮
它	宀匕
明	日月
老	耂匕
者	者一
公	公ノ
见	见丨
机	木几
向	向口
问	门口
最	日耳
使	亻同
全	人王
点	占灬
情	忄青
外	夕卜
民	民ㄋ
并	䒑廾
战	占戈
关	䒑大
工	工一丨
回	回丨
等	土
相	相一
二	二一一
重	千里
由	由丨
头	⺀大
声	士
性	忄生
应	广兴
间	门日
话	讠舌
文	文丶
给	纟合
美	大
业	业丨丨
物	牜勿
真	直八
体	亻木
或	戈口
政	正攵
几	几ノ
内	内丨
利	禾刂
打	扌丁
走	走一丨
新	立朩
位	亻立
西	西一丨
再	一冉
产	产丶
加	加ㄋ
月	月ノ
却	去卩
先	先ノ一
制	巾
特	牜土
果	日木
东	东一ㄋ
神	礻日
儿	儿ノ
才	才一
门	门丶丨
太	大丶
合	合ノ丶
信	亻言
表	
原	厂白
女	女ㄋ
更	更一丨
己	己ㄋ一
名	夕口
立	立丶
比	比一ㄋ
代	代ノ
四	四丨
斯	其斤
任	亻壬ノ
次	次丶
世	世一
便	亻更一
听	口斤
提	扌是
做	亻古ノ
海	氵每
水	水丨
教	耂子
眼	目艮
化	亻七
通	甬辶
感	咸心
王	王一
各	各ノ
口	口丨
气	气ノ一
别	另刂
少	小丿
处	夂卜
平	平一丶
常	巾
解	角刀
何	亻可
接	扌立
目	目丨
反	又
变	亦又
笑	夭
总	总心
入	入ノ丶
认	讠人
条	夂朩
安	宀女ㄋ
金	金ノ丶
及	及ノ
让	讠上
度	度又
山	山丨
马	马ㄋ
受	受又
活	氵舌
结	纟吉
数	米女
直	直一丨
必	必丶ㄋ
白	白ノ丨
指	扌旨
张	弓长ノ
报	扌卩
论	讠人ノ
员	口贝
义	丶乂
放	方攵
电	日乚
至	至一ㄋ
五	五一丨
系	丿糸
难	又隹
命	合卩
建	聿廴
尔	尔ノㄋ
件	亻牛
死	歹匕ノ
保	华口
完	宀元
许	讠
题	是页一
场	土汤
空	穴工
计	讠十
怎	乍心丶
光	光丨
管	宀
非	非丨一
德	彳十
强	弓口
量	旦里丨
决	冫夬
形	开彡
像	亻象
期	其月
资	次贝
队	阝人
清	氵青
务	夂力
统	纟
书	
市	亠巾
司	同
师	一丨
住	亻主丶
即	卩
克	古儿
带	带一丨
飞	
南	十冂
区	区一ノ
李	木子
则	贝刂
觉	学见
交	交丶一
社	礻土
今	今ノ
基	其土
北	北丨一
展	尸
传	亻专一
连	车辶
叫	口丩
治	氵台
路	各
万	万一ㄋ
告	告ノ一
科	禾⺀
呢	口尸
思	田心丶
达	大辶
记	讠己
转	车专一
望	亡月
边	力辶
快	忄夬
风	风ノㄋ
色	巴
该	讠亥丶
界	田人ノ
象	象ノㄋ
权	木又
拉	扌立丶
设	讠殳
且	且丨ㄋ
取	耳又
干	干一一
收	丩攵
步	止
领	令页
林	林一丨
根	木艮
往	彳主丶
亲	立朩一
极	木及
求	求一丨
未	未一一
每	每ノ
程	禾口一
式	弋工
兵	丘八
据	扌尸
类	米大
言	言丶
规	夫见
吧	口巴
品	口吅
确	石角
观	又见
城	土戊ㄋ
虽	口虫
失	丿夫一
格	木各ノ
远	元辶丶
办	力八
元	元一一
运	云辶丶
令	令ノ丶
共	共一丨
似	亻以ㄋ
准	冫隹
请	讠青
武	一弋丨
士	士一
改	己攵ノ
英	艹央
术	木丶丶
车	车一ㄋ
石	石一ノ
深	氵冖
联	耳䒑
争	争ノㄋ
吗	口马
院	阝宀
轻	车轻
火	火丶ノ
罗	罒夕ノ
百	百一ノ
夫	夫一一
离	㐫禸
花	荷七ノ
近	斤辶丶
切	七刀
识	讠口
造	告辶
组	纟且丨
流	氵㐬丶
算	目
布	巾丨
导	巳寸
早	早丨ㄋ
找	扌戈
候	攸
满	氵艹
服	月卩
官	宀㠯
整	束攵
爱	受
字	宀子ㄋ
持	扌土
跟	艮
突	穴犬
影	日京
消	氵肖丨
吃	口
随	阝
商	商丶
证	讠正
单	单丶
议	讠丶ノ
越	走戉
存	在子
击	凵
精	米青
济	氵文
始	女台
台	台ㄋ
黑	黑丨
调	讠冂
需	雨而
支	十又ㄋ
杀	乂朩
团	囗才一
功	工力
具	八
华	华七
脸	月佥
府	广付ノ
集	隹木
周	冂吉
青	青一一
红	纟工一
双	双ㄋ丶
九	九ノ
八	八ノ丶
片	片ノ丨
半	半丶ノ
容	宀谷ノ
曾	曾丶ノ
阿	阝可
落	落各
显	日业丨
除	阝余
尽	尺⺀
党	儿
照	日召
众	人从ノ
备	夂田丨
复	复ノ一
陈	阝东一
断	米乚ノ
价	亻人ノ
约	纟勹丶
写	冖与
包	勹巳ㄋ
级	纟及ノ
另	另丨
病	疒丙ノ
质	十丨
称	禾尔
倒	亻至丨
江	氵工一
绝	纟
敌	舌攵
黄	由ノ
技	扌十
六	六丶
朝	月ノ
派	氵ノ
线	纟戋
站	立占丨
究	穴九
装	丬士
亚	亚一
首	䒑自ノ
刚	冈刂丨
示	示一一
视	礻见丨
况	冫口
增	土曾丶
谈	讠炎丶
惊	忄京
古	古一丨一
史	口乂ノ
谁	讠隹ノ
引	弓丨丨
须	彡页
七	七一ㄋ
息	自心丶
研	石开
际	阝示一
器	吅犬
易	日勿
留	留田丨
推	扌隹
坐	从土一
房	户方丶
广	广丶一
注	氵主丶
查	木旦丨
语	讠五丨
念	今心丶
若	艹丨
奇	大可
紧	坚糸ㄋ
企	人止丨
希	希ノ丶
委	禾女ㄋ
响	口向丨
号	口丂一
参	叁彡
势	执力ㄋ
历	厂力ㄋ
剑	佥刂
攻	工攵ノ
冷	冫令
投	扌殳ノ
哪	口
农	农丶ㄋ
专	专一一
图	囗夂
考	耂丂
选	先辶丶
终	纟夂丶
微	微几
皇	白王一
土	土一丨
局	尸丨
星	日生ノ
足	足丨ㄋ
刘	文刂丨
甚	其乚ㄋ
严	亚丿
医	匚矢
男	田力
营	劳口丨
乎	乎ノ丶
仅	亻又ㄋ
父	父ノ丶
拿	合手ノ
孩	孑亥
答	合ノ
啊	口阝
费	弓丨
标	木示一
依	亻衣丶
兴	兴八
低	亻氏丶
千	千ノ一
仍	亻乃ㄋ
急	刍心
护	扌户丶
竟	音儿
某	甘木一
较	车交丶
防	阝方
列	歹刂丨
讲	讠井一
破	石皮ㄋ
客	宀各
施	族也
故	古攵ノ
血	丿皿丨
节	艹ㄗ
云	云一一
龙	龙一ノ
钱	钅戋
苏	艹力ノ
母	母ㄋ
伤	亻ㄋ
举	兴八一
族	族矢ノ
按	扌宀ㄋ
维	纟隹
修	攸夂ノ
帝	帝巾丨
河	氵可
威	戊一
巴	巴ㄋ丨
划	戈刂
致	至攵ノ一
案	宀女一
革	革一丨
底	广氏
送	䒑大丶
冲	冫中
音	音丶
态	大丶丶
够	句夕
段	段ノ丨
构	木勹ㄋ
群	尹口丶
船	舟几丨
责	贝丨
苦	艹古一
章	音十一
律	彳聿ㄋ
愿	厂白丨
围	囗韦
京	京丶一
衣	衣丶
喜	壴口
独	犭虫
效	交攵
斗	⺀十一
细	纟田丨
怕	忄白ノ
志	士心丶
米	米丶
晚	日免ノ
热	执灬
项	工页
料	米⺀
例	亻歹丨丨
灵	彐火丶
密	宀必丨
害	宀丰丨
供	亻共一
属	尸禹ノ
验	马佥ノ
境	土音
毛	毛ノ一
般	舟殳
居	尸古一
继	纟米
错	钅昔
沉	氵冖ノ
采	爫木
既	旡一
察	宀祭ノ
否	不口
批	扌比一
脑	月㐫丶
夜	夜丶一
股	月殳ノ
速	束辶丶ㄋ
纪	纟己ㄋ
续	纟十ㄋ
假	亻叚ㄋ
帮	阝
乐	小丨
陆	阝ㄋ
型	开刂一
退	艮辶丶
友	又ㄋ
铁	钅丿一
汉	氵又ㄋ
暗	日音
状	丬犬一
左	工
句	句ノㄋ
雷	雨田丨
网	冂乂ノ
率	玄一
值	亻直一
普	並日丨
承	了三
停	亻亮一
试	讠弋
弹	弓单
止	止丨一
职	耳口ノ
药	艹纟
久	久ノㄋ
印	卩
卫	ㄗ一一
助	且力ㄋ
掌	手ノ
织	纟口ノ
阳	阝日丨
待	彳土一
初	衤刀ㄋ
追	辶
木	木一丨
哈	口合ノ
您	亻尔丶
预	予页一
刻	亥刂丨
创	仓刂丨
诉	讠斤丶
简	门
射	身寸
限	阝艮ㄋ
球	王求一
差	工一
树	木又一
校	木交丶
兰	兰丶ノ
怪	忄又一
阵	阝车一
异	巳廾一
宗	宀示一
波	氵皮
育	⺝丨
激	氵白丶
担	扌旦丨
顿	屯页
游	氵族ㄋ
充	儿ノ
银	钅艮ㄋ
适	舌辶丶ㄋ
省	小丿丨
胡	古月ノ
食	食ノ丶
警	艹句ノ
素	糸
尼	尸匕ノ
排	扌非丨
负	贝丨
背	北⺝
忽	勿心丶ㄋ
酒	氵酉一
穿	穴牙一
福	礻同
弟	弟丶ノ
怀	忄不一
欢	又欠ノ
环	王不一ノ
招	扌召ㄋ
模	木莫一
胜	月生ノ
痛	疒甬ㄋ
习	习ㄋ
险	阝佥
财	贝才
益	䒑八
宝	宀王丶
脚	月去
疑	疑ノㄋ
乱	舌乚ㄋ
赶	走干一
坚	坚土一
获	艹犭
劳	劳力
挥	扌冖
敢	敢攵ノ
置	罒直一
右	口丨
压	厂土丶
香	禾日丨
层	尸云一
略	田各ノ
静	青争ノ
村	木寸
范	落㔾
源	氵厂ノ丨
副	同田丨
州	川丶
纳	纟内
岁	山夕ノㄋ
罪	罒非
余	余ノ丶
闻	门耳一
占	占丨一
玉	王丶丶
哥	可可一
杨	木汤ㄋ
忙	忄亡
兄	口儿ノ
守	宀寸一
跑	勹ㄋ
述	木丶丶ㄋ
座	广从一
田	田丨ㄋ
摇	扌爫ノ
超	走召ㄋ
演	氵㝉丨
皮	皮ㄋノ
喝	口曷丨
买	买ㄋ丶
佛	亻弓ノ丨
室	宀至
角	角ノㄋ
卡	上卜丨丶
封	圭寸一
策	朿一
块	土夬ㄋ
富	宀同丨
判	半刂丨
配	酉己ㄋ一
姑	女古一
优	亻尢丶
征	彳正一
善	羊䒑丨
刀	刀ㄋノ
娘	女良丶
降	阝夂一
恶	亚心丶
宣	㝉旦
慢	忄日
积	禾口ノ
草	艹早丨
恐	工凡
妈	女马ㄋ
读	讠十ㄋ
靠	告非丨
阶	阝人ノ
楚	林疋ㄋ
姐	女且
执	执一丨
呼	口乎ノ
协	十力ノ
洲	氵川
巨	匚ㄋ
免	免ノㄋ
检	木佥ノ丶
养	羊丶
顾	厂㔾一
救	求攵ノ
份	亻分ノ
控	扌穴一
抗	扌亠ノ
著	艹者一
赵	走乂
肯	止⺝
露	雨ノ
换	扌丨
登	登ㄋ
伊	亻尹ㄋ
犯	犭㔾ㄋ
尚	尚丨丶
莫	莫一丨丶
危	厃㔾ㄋ
审	宀日丨
掉	扌卓丨
亦	亦丶一丶
沙	氵小ノノ
散	⺝ノ
欧	区欠ノ
唐	广肀丨ㄋ
枪	木仓ノ
宫	宀口
魔	麻鬼
耳	耳一丨
屋	尸至一ㄋ
永	永丶ㄋ
孙	孑小丨
临	丶
圣	又土
叶	口十一
毫	亮毛ノ
宋	宀木一
谢	讠身
讨	讠寸
温	氵日丨
嘴	口此ノ
航	舟亠ノ
毒	母ㄋ
呀	口牙一
野	里予ㄋ
逃	儿丶ㄋ
托	扌乇ノ
伯	亻白ノ丨
索	孛糸
岛	山丨
贵	贵丨ㄋ
顺	川页一
楼	木米ㄋノ
遇	禺辶丶
良	良丶ㄋ
朋	月月ノ
坏	土不一
亮	亮几ノ
户	户丶ㄋ
景	日京丶
烈	歹刂丶
闪	门人ノ
礼	礻乚
艺	艹乙
互	一彑ㄋ
丝	一
秘	禾必丶
渐	氵车ノノ
架	加木一
鱼	鱼ノㄋ
升	丿廾
抓	扌爪ノノ
监	监皿丨
君	尹口丨
短	矢豆一
梦	林夕ノ
隐	阝刍丶
困	囗木一
税	禾总ノ
洋	氵羊丶ノ
鬼	鬼ノ丨
炮	火勹ㄋ
舰	舟见丨
付	付ノ丨
诸	讠者一
货	亻七丨
松	木公
归	彐ㄋ
败	贝攵ノ
幸	土丶
概	木
寻	彐寸一
评	讠平一
吸	口及ノ
恩	因心丶
介	人
朱	丿未一
探	扌冖ノ
县	且厶ㄋ
脱	月总ノ
移	禾夕ノㄋ
缺	缶夬
画	一田ㄋ
误	讠口一
释	丿米ㄋ
旁	帝方丶
跳	儿
藏	艹戊ㄋ
春	日丨
睡	目垂ノ
吉	吉一丨一
端	立山一
味	口未一
杂	九朩一
翻	番羽ㄋ
雪	雨彐ㄋ
遗	贵辶丶
款	士示ノ
刺	朿刂丨
附	阝付
爷	父卩ㄋ
核	木亥丶
央	央丨ㄋ
减	冫咸一
阴	阝月
编	纟户丨
版	片ㄋ
智	矢口丨
齐	文ノ
雨	雨一丨丶
徐	彳余ノ
鲁	鱼日丨
仙	亻山丨
湖	氵古ノㄋ
钟	钅中
蒙	劳一一
丽	丽一
班	王一
咱	口自ノ
康	广隶ㄋ
损	扌口
震	雨辰
借	亻昔一
固	囗古一丨
诗	讠土一
镇	钅直ノ
吴	口天一
域	土戈丨
均	土勹丶
秦	禾ノ
妇	女彐ㄋ
鲜	鱼羊丶
序	广予ㄋ
烟	火因丨
洞	氵冂一
猛	犭子丨
测	氵贝丨
练	纟练一
旧	丨日丨
堂	土一
笔	毛ノ
饭	饣ㄋ
顶	丁页
灭	一火丶
庄	广土一
括	扌舌ノ
怒	奴心丶
补	衤卜丨丶丶
逐	豕辶丶
毕	比十一
席	度巾丨
禁	林示一一
剧	尸古丨
乡	乡ㄋ
湾	氵亦ㄋ
卖	十买ㄋ
牛	牛ノ
避	辟辶丶
欲	谷欠ノ
弄	王廾一ノ丨
忍	刀丶丶
旅	族ノ
暴	日共丨
虚	虍业丨
额	宀各一
含	今口丨
忘	亡心丶ㄋ
抱	扌勹ㄋ
油	氵由丨
肉	内人ノ
输	车俞ノ
洛	氵各ノㄋ
祖	礻且丨ㄋ
迎	卩丶
缓	纟爰ノ
虎	虍几ノ
票	覀示一
销	钅肖
婚	女氏丨
乃	乃ㄋノ
板	木ㄋ
冰	冫水丨
录	录ㄋ
伸	亻日丨
遍	户丶
虑	虍心丶
宁	宀丁一丨
臣	臣一丨ㄋ
玩	王元一
熟	享九丶
谷	谷ノ丶
予	予ㄋ丶
谋	讠甘一
炸	火乍ノ
督	上小
奥	向米一
狂	犭王一
亡	亡丶一
港	氵共ㄋ一
庭	广壬ㄋ
博	十甫一
材	木才一
俄	亻我ノ
韩	韦一
混	氵日一ㄋ
词	讠一
盘	舟皿丨
尊	酋寸一
寒	寒⺀丶
遭	曹辶丶
训	讠川ノ
拍	扌白ノ丨
麻	麻丶一
荣	劳木一
卷	㔾ㄋ
夏	丆目ノ
谓	讠田丨
凡	凡ノㄋ
私	禾厶ㄋ
厂	厂一ノ
丁	丁一丨丨
骨	骨丨ㄋ
牙	牙一ㄋ
休	亻木一丨
迫	白辶丶
授	扌受ㄋ
替	夫夫丨
拥	扌用ノ
摆	扌罒一
默	黑犬一ノ
勒	革力
骑	马大一
泽	氵又一
疗	疒了ㄋ
睛	目青一
店	广占丨
载	车一
诺	讠艹一
健	亻聿ㄋ
扬	扌汤ㄋ
纸	纟氏ノ
透	禾乃丶
床	广木一
唯	口隹ノ
岸	山厂一
迅	十丶ㄋ
尤	尢丶丶丶
稳	禾刍丶
园	囗元一一
徒	彳走一
伦	亻人ノㄋ
坦	土旦丨
择	扌又一
蓝	艹监丨
握	扌尸一
抵	扌氏丶丶
姓	女生
郑	䒑大ㄋ
弱	弓冫ㄋ
软	车欠ノ
绿	纟录ㄋ
叹	口又ㄋ
轮	车人ノ
束	束一丨丶
盖	皿丨
丈	丶丶
午	十
篇	户丨
窗	穴囟ノ
歌	可可ノ
雄	厶ノ
森	木林一
醒	酉日ノ
伙	亻火丶
残	歹戋一
戏	又戈
妻	妻女ㄋ
折	折一丨丨
甲	甲丨ㄋ
啦	口扌丶
套	大镸
塔	土艹ノ
馆	饣宀丨
秋	禾火丶ノ
梅	木每ノ
迷	米辶丶ㄋ
典	曲八
灯	火丁一
厉	厂万一
秀	禾乃ㄋ
扩	扌广丶
曲	曲丨ㄋ
爸	父巴
努	奴力ㄋ
潜	氵夫一
街	彳圭一一
硬	石更一丨
宇	宀于一一
哭	吅犬一
阻	阝且丨
萨	艹阝
纵	纟从ノ
喊	口咸一
搞	扌高丶
冒	日目丨
罢	罒去一
盛	戊丨
塞	寒土一
妹	女未一一
萧	艹肀ノ
桌	卓八ノ
圆	囗口丨
纷	纟分ノ
悲	非心丶ㄋ
鼓	壴十ㄋ
淡	氵炎丶
访	讠方丶
础	石出ㄋ
杜	木土一
宽	宀艹丨
拜	一一一
犹	犭尢丶
抽	扌由丨
刑	开刂丨
偏	亻户丨
奔	大十一
侵	亻彐丶
延	丿止ㄋ丶
懂	忄艹ノ
蒋	艹丬ノ
针	钅十一丨
抬	扌台ㄋ
舞	卌一
赞	先先丨
侧	亻贝丨丨
赛	寒贝丨
纯	纟屯一
申	日丨丨
夺	大寸一
柳	木卯ㄋ
距	匚
丹	丹ノㄋ
仿	亻方丶
川	川ノ丨
途	余辶丶ㄋ
曹	曹一丨
购	贝勹ㄋ
亿	亻乙ㄋㄋ
乌	乌一一
胸	月勹ノ
浪	氵良丶
贝	贝丨ㄋ
偷	亻俞
姆	女母
竞	立口ノ
茶	艹人一
末	末一一丶
毁	臼工ノ
烧	火尧一
伟	亻韦一一
库	广车一ㄋ
弃	廾一
墙	土十丶
雅	牙隹ノ
贸	留贝丨ㄋ
沿	氵几
爆	火日一
振	扌辰一
趣	走耳ㄋ
操	扌口丨
诚	讠戊ㄋ
挑	扌儿丶
杰	木灬丶
轰	车双ㄋ
盟	日月丨
勇	甬力ㄋ
敬	艹句ノ一
狗	犭句ノㄋ
恨	忄艮ㄋ
迹	亦辶丶
呆	口木一丨
疾	疒矢ノ
哲	折口丨
促	亻足丨
麦	夂ノㄋ
丰	丰一一
横	木丨ㄋ
闭	门才一
撤	扌丨
析	木斤ノ
挂	扌圭一
彩	爫木ノ
埃	土厶ノ
召	召ㄋノ
童	立里丨
摩	麻手ノ
乘	禾北丨一
符	付ノ
筑	工ノ
眉	目
侠	亻夹ノ
袭	龙衣丶
孤	孑瓜ノ
培	土立丨
耶	耳阝ㄋ
染	氵九一
稍	禾肖
妙	女小ノ
凶	㐅凵ㄋ
页	页一ノ
戴	田
洗	氵先ノ
陷	阝ノ
络	纟各ノㄋ
植	木直一
厚	厂日ㄋ
措	扌昔一
瓦	瓦一ㄋ
援	扌爰ノ
汇	氵匚一
触	角虫
售	隹口丨ㄋ
违	韦辶丶
粮	米良丶
泪	氵目丨
彻	彳七ㄋ
洪	氵共一丨
献	十冂丶ノ
魂	云鬼ノ丨
抢	扌仓ノ丶
玄	玄丶一
巧	工丂一
珠	王丿一一
劲	轻力ㄋ
彼	彳皮ㄋ
摸	扌莫一丨
凭	亻壬ノㄋ
暂	车斤丨
碰	石並丶
皆	比白ノ
尖	小大一
忠	中心丶
奉	
享	享丶一
聚	耳又ノ
胆	月旦丨
厅	厂丁一
闹	门亠丨
灰	火丶
津	氵聿ㄋ
倾	亻一
订	讠丁一
鸟	鸟ノㄋ
扑	扌卜丨
孔	孑乚ㄋ
汽	氵气ノ
吓	口下一丨丶
驻	马主丶一
叔	上小ㄋ
凤	几又ㄋ
紫	此糸ㄋ
妖	女夭ノ
凌	冫土
唱	口日丨
梁	氵刀ノ
箭	前丶
融	鬲虫丨
殊	歹丿一一
课	讠日一丨
莱	艹夹丨
奴	奴ㄋノ
肩	户⺝丨
扫	扌彐ㄋ
鼻	自畀丨ㄋ
庆	广大一
镜	钅音ノ
菜	艹爫一
恢	忄丶
御	彳丨一
烦	火页
裁	衣
估	亻古一丨
隔	阝鬲
尸	尸ㄋ一
尾	尸毛ノ
仪	亻丶ノ丶
瞧	目隹丶
迟	尺辶丶ㄋ
圈	囗ㄋ
译	讠又一一
骂	吅马ㄋ
珍	王㐱ノ
币	丿巾丨
惨	忄叁ノ
剩	禾北丨丨
愈	俞心丶
飘	覀示ノㄋ
荒	艹亡ノ
惯	忄毌丨
缘	纟彖ㄋㄋ
曼	日罒ㄋ
舍	舍ノ丶
季	禾子ㄋ
旗	族其一
艾	艹乂ノ
牌	片卑
恰	忄合ノ
腰	月覀ㄋノ
废	广发ㄋ
腿	月艮丶
玛	王马ㄋ
累	田糸ㄋ
涉	氵止丨
燕	廿口丨
朗	朗月ノ
颗	日木一ノ
签	佥ノ
吹	口欠ノ
罚	罒讠丨
拒	扌匚ㄋ
仰	亻ㄋ
描	扌艹丨
杯	木不一
奖	奖大一
奋	大田丨
奶	女乃ㄋ
贫	分贝丨
甘	甘一丨一
婆	氵皮ㄋ
繁	每攵ㄋ
穷	穴力ㄋ
伏	亻犬一ノ
幕	莫巾丨ㄋ
殿	尸共ノ
沈	氵冖ノㄋ
绍	纟召ㄋ
启	户口
缩	纟宀ノ
粗	米且
弗	弓ノ
患	口中丶ㄋ
仇	亻九ノ
债	亻丨
碎	石卒丶
挺	扌壬ㄋ
泰	氺丨
羊	羊丶ノ丨
旋	族疋ㄋ
晓	日尧一ㄋ
障	阝音
桥	木夭ノ
仁	亻二一一
郎	朗阝
孟	子皿丨
讯	讠一
虫	虫丨ㄋ
郭	享阝ㄋ
幻	幺ㄋ
赫	赤赤一丨
裂	歹刂丶一
凝	冫疑ノ
颜	产彡
刊	干刂丨丨
慈	䒑幺ㄋ
吕	口口丨ㄋ
昨	日乍ノ
辛	辛丶一丨
役	彳殳ノㄋ
逼	同田丶
泛	氵丿丶
瑞	王山一
伴	亻半丶
袁	土口ノ
翼	羽田
舒	舍予ㄋ
宜	宀且丨
偶	亻禺丨ㄋ
峰	山夂一一
径	彳轻ㄋ
岂	山己ㄋ
潮	氵ノ
捕	扌甫一丨
辆	车丙ノ
邪	牙阝ㄋ
症	疒正一
颇	皮页一ノ
插	扌千ノ丨
袋	代衣丶
爬	爪巴
掩	扌大丨
霍	雨隹ノ
浮	氵爫ㄋ
倍	亻立丨
壮	丬士一
豪	亮豕一
拔	扌ㄋ
拖	扌ㄋ丨
渡	氵度ㄋ
悄	忄肖丨
堆	土隹ノ
鸡	又鸟ノㄋ
狼	犭良丶
播	扌番ノ丶
零	雨令ノ丶
躲	身几
映	日央丨
灾	宀火丶ノ
尺	尺ㄋ
俗	亻谷ノ
疯	疒风ノ
丧	十䒑ㄋ
冬	夂⺀丶
辩	辛讠丶
炎	炎丶ノ
咬	口交丶
码	石马ㄋ
猜	犭青一一
壁	辟土
艘	舟臼丨
滚	氵六ㄋ
贴	贝占丨
赏	贝丨
劝	又力ㄋ
兽	丷田
番	番ノ丶
哼	口亨丶
撞	扌立丨
伍	亻五一
柔	矛木一
旦	旦丨
跃	夭ノ
隆	阝夂一ノ
魏	禾女ノ丨
狠	犭艮ㄋ
糊	米古ノㄋ
扎	扌乚ㄋㄋ
忧	忄尢丶
衡	彳丨
帐	巾长ノ
崇	山宀一一
汗	氵干一
赖	束丨
薄	落甫一
净	冫争ノ
粉	米分ノ
岩	山石一ノ
忆	忄乙ㄋ
堡	华口一
巡	巛辶丶
仔	亻子ㄋ
欣	斤欠ノㄋ
偿	亻丶ㄋ
愤	忄十一
阁	门各ノ
详	讠羊丶
竹	竹ノ一
董	艹千丨
漫	氵日丨ㄋ
撒	扌丨ㄋ
佩	亻几一丨丨
丢	丿去一丨
绕	纟尧一
赤	赤一丨丶
扶	扌夫一一
蛋	疋虫丨ㄋ
吐	口土一
返	又丶
闲	门木一丨
陪	阝立丨
乔	夭ノ
盾	十丨ㄋ
矿	石广丶一
矛	矛ㄋ丶ノ
耐	而寸一丨
焦	隹灬丶
侍	亻土一
拳	手
墨	黑土一丨
侯	亻ノ
允	厶儿ノ
滑	氵骨丨
润	氵门一一
胞	月勹ㄋ一
邦	阝ㄋ
辈	非车一ㄋ
井	井一一丨
荷	荷可一
摄	扌耳ㄋ
署	罒者一
荡	落汤
敏	每攵ノ
递	弟辶丶
泥	氵尸ノㄋ
骗	马户丨
曰	曰丨ㄋ
彭	壴彡ノ
租	禾且
晨	日辰一
搜	扌臼丨
昏	氏日
幅	巾同丨
奏	夭
幽	山幺ㄋ
兼	兼丶ノ
肃	肀ノ
艇	舟壬ㄋ丶
辑	车口一丨一
枝	木十ㄋ
岳	丘山丨
黎	禾勹ノ丨
浓	氵农丶ㄋ
酸	酉夋ㄋ
污	氵亏一
凉	冫京丶
辞	舌辛丶
嘛	口麻丶
戒	戈廾
躺	身尚丨
菲	艹非丨
垂	垂ノ一
贯	毌贝
炼	火练一
苍	艹仓ノ
箱	相一
驾	加马ㄋㄋ
驱	马区一ノ
凯	山己ノㄋ
截	隹ノ
埋	土里丨ㄋ
拼	扌䒑一
涌	氵甬ㄋ
乏	丿之丶ㄋ
腾	月ㄋ
悉	丿米丶
冯	冫马
诊	讠㐱ノ
皱	刍皮ㄋ
桑	又双一
漂	氵覀一一
慧	丰丰ㄋ一
蛇	虫宀ノ
恭	共丨丶
迪	由辶丶
恋	亦心丶
侦	亻⺊丨
钢	钅冈丨
氏	氏ノㄋ
贼	贝戈一
燃	火一
饮	饣欠ノ
碍	石旦一丨
韦	韦一一丨
尘	小土一丨
餐	⺊夕ㄋ
邓	又阝ㄋ
阅	门总ノㄋ
液	氵夜丶
欺	其欠ノㄋ
呵	口可一
牵	大冖ノ
综	纟宀一一
俩	亻丙ノ丶
踪	宀一
殖	歹直一丨
趋	走刍ノ
磨	麻石一
绪	纟者一丨
锁	钅丨
陶	阝勹ノ一
蒂	艹帝丨ㄋ
慌	忄艹丶
臂	辟⺝丨
慕	莫丨丶
晋	亚日丨ㄋ
卢	⺊尸ㄋ
惠	惠心丶
储	亻讠一丨
汤	氵汤ㄋ
宪	宀先ノ
扰	扌尢丶
宙	宀由丨ㄋ
聪	耳总丶
怨	夗心丶
呈	口王一一
跌	丿一
匆	勿丶丶
铺	钅甫一丨
脉	月永丶
锋	钅夂一一
劫	去力ㄋ
芳	艹方丶
宾	宀丘ノ
帕	巾白ノ丨
盗	次皿丨ㄋ
佳	亻圭一丨
遵	酋寸丶
哦	口我ノ
幼	幺力ㄋノ
仗	亻丶丶
伪	亻为丶ノ
驶	马口ノ
腹	月复
牧	牛攵ノ一
踏	水丨
惜	忄昔一
朵	几木一丨
袖	衤由丨
胁	月力ノ
抛	扌九ㄋノ
霸	雨革ノ
媒	女甘一
频	止一ノ
勃	孛子ㄋ
盯	目丁一丨
抚	扌一一
弯	亦弓ㄋ
扭	扌丑ㄋ
册	冂冂一
励	厂万ㄋノ
颤	亠回丨
键	钅聿ㄋ
勤	堇力ㄋ
贡	工贝丨
洁	氵吉一
怜	忄令ノ
寿	寸一
腊	月昔一
贺	加贝丨
雾	雨夂ㄋ
龄	齿令ノ
椅	木大一丨
挤	扌文ノ丨
扣	扌口丨ㄋ
届	尸由丨ㄋ
券	刀ㄋノ
熊	厶⺝ノ
爹	父夕ノ
尝	冖一
询	讠勹丨
喷	口十一丨丶丶
娇	女夭ノ丨
夹	夹人ノ
肥	月巴ㄋ
祝	礻口ノㄋ
吾	五口丨
寄	宀大一
疼	疒夂丶
斜	余⺀一丨
拟	扌以ㄋ丶
迁	千辶丶ㄋ丶
钻	钅占丨
浑	氵冖一
肚	月土一
艰	又艮ㄋ一
牢	宀牛ノ一
惧	忄ノ丶
挡	扌ㄋ一
敲	高⺊ㄋ丶
庞	广龙一ノ
叛	半ㄋ
鸣	口鸟ノ
柏	木白ノ
薛	艹丶
屈	尸出ㄋ丨
叙	余又ㄋ丶
悟	忄五丨
坡	土皮ㄋノ
腐	广付丨
辽	了辶丶ㄋ
匹	匚儿ノ
铜	钅冂一
籍	耒一丨
穆	禾白丨
割	宀丰丨ㄋ
旨	旨ノㄋ
擦	扌宀ノㄋ
沟	氵勹ㄋ
抖	扌⺀一丨丨
掠	扌京丶
奈	大示一
泉	白水丨
狱	犭讠一ノ
揭	扌曷丨
晃	日光
怔	忄正一丨
猎	犭昔一
诱	讠禾ㄋ
娜	女ㄋ
猫	犭艹丨ㄋ
醉	酉卒丶
祭	祭ノㄋ丶
貌	豸白ノ
池	氵也ㄋ
琴	王王ノ丶
寂	宀上丨ノ
遥	爫缶丶ㄋ
瓶	䒑廾一
羽	羽ㄋ丶
昆	日比一
辉	光冖一
吞	天口丨ㄋ
牲	牜生ノ一
哀	哀ノㄋ丶
昌	日日丨
厌	厂犬一
晶	日日丨ㄋ
剂	文丨丨
绩	纟丨
筹	一丨
柱	木主丶一一
搬	扌舟ノㄋ
莲	艹车丶
鹰	广亻ノ丨
鞋	革圭一
俊	亻夋ㄋ丶
恼	忄㐫丶一
瞪	目登ㄋ丶
俱	亻ノ
稿	禾高丶
搭	扌艹ノ丶
僧	亻曾丶ノ一
纠	纟丩ㄋ
亏	亏一一ㄋ
睁	目争ノ
弥	弓尔ノㄋ
践	戋一
猪	犭者一丨
瘦	疒臼丨
迈	万辶丶ㄋ
浅	氵戋一
挣	扌争ノㄋ
逻	罒夕丶ㄋ
宿	宀亻一
疲	疒皮ㄋノ
邻	令阝
惑	戈口一
胖	月半丶ノ
跪	厃ㄋ
丛	从一一一
傻	亻囟ノ丶
贾	覀贝丨
稀	禾希ノ
脏	月广一丨
慰	尸示一
廷	壬廴ㄋ
饰	饣丨
鉴	监金ノ
贷	代贝丨ㄋ
祥	礻羊丶
葛	艹曷丨
冠	冖元一
跨	大一一
耗	耒毛ノ
赔	贝立丨ㄋ一
悬	且厶丶
仲	亻中丨
拦	扌兰丶ノ
嗯	口因丶
戈	戈一ㄋ
粒	米立丶一
遣	中一丨
捉	扌足丨ㄋ
赢	赢贝丨
拨	扌发ㄋノ
傅	亻甫一丨
锦	钅白丨
仆	亻卜丨丶
趁	走㐱ノ丶
贤	坚贝丨ㄋ
贪	今贝
澳	氵向丶
削	肖刂丨丨
衰	哀一ノ
扔	扌乃ㄋ
卓	卓丨一
湿	氵日丨丨
瞬	目受ノㄋ
桃	木儿丶
鼠	鼠ノ丨
辖	车宀一一
遂	㒸辶丶ㄋ
闷	门心丶
雕	冂吉ノ
邮	由阝ㄋ
誉	兴八丶
暖	日爰ノ丶
阔	门氵ノ一
乾	
祸	礻呙丨
枚	木攵ノ一
押	扌甲丨
梯	木弟丶
豆	豆一丨一
歇	曷欠ノ
嫌	女兼丶ノ
碗	石宀ノ
涂	氵余ノ丶
挖	扌穴ㄋ
抑	扌ㄋ
烂	火兰丶ノ
契	丰刀一
循	彳一丨
娃	女圭一丨
渔	氵鱼
嘉	壴加ㄋ
丑	丑ㄋ丨
赋	贝一一
斤	斤ノノ
勾	勹厶ㄋ
寺	土寸一丨
吼	口孑ㄋ
坛	土云一
惟	忄隹ノ
邀	白方ノ一
械	木戈一
滴	氵啇丶一
赴	走卜丨
堪	土其ㄋ
帽	巾日丨
帅	巾丨
逊	孑小丶
傲	亻敖一一
吨	口屯一ㄋ
仓	仓ノ丶
浩	氵告ノ
寸	寸一丨丶
姿	次女ㄋノ
覆	覀彳ノ
闯	门马ㄋ
愚	禺心丶
痕	疒艮ㄋ
牺	牜西一
瑟	王王丶ㄋ
唤	口丨
赌	贝者一丨
庙	广由丨
蔡	艹祭ノ
扁	户丨
煤	火甘一丨
哩	口里丨ㄋ
玻	王皮ㄋ
汪	氵王一一
苗	艹田丨
峡	山夹ノ
敦	享攵ノ一
逆	屰辶丶ㄋ
纹	纟文丶一
宅	宀乇ノ一
妥	爫女ㄋ
忌	己心丶ㄋ
郁	⺝ㄋ
笼	龙一ノ
盐	土卜丨
玲	王令ノ
耀	光羽ノ丨
唇	辰口丨
慎	忄直ノ丶
秩	禾丿一
涨	氵弓ノ
墓	莫土一
饿	饣我ノ一
陵	阝土ノ丶
羞	丑ㄋ
恒	忄一丨
纽	纟丑ㄋ丨
弓	弓ㄋ一
糖	米广ㄋ一
锐	钅总ノㄋ
缝	纟夂一
夸	大亏一
喘	口山一
碧	王白一ノ
卧	臣卜丨
宏	宀ㄋ
岗	山冈丨
惩	彳正丶
谨	讠堇一
疏	㐬丶一
斥	斤丶丶
滋	氵䒑ㄋㄋ
串	口中丨
漠	氵莫一丨
屏	尸䒑一
悔	忄每ノ
溜	氵留丨
挨	扌厶ノ
档	木ㄋ
扇	户羽ㄋ
雇	户隹ノ丨
蛮	亦虫丨ㄋ
鸿	氵工ノㄋ
歼	歹千ノ
砍	石欠ノ
糟	米曹一
欠	欠ノㄋ丶
添	氵天丨丶
柴	此木一
屠	尸者一丨
勉	免力ㄋ
肌	月几ノ
齿	齿丨一丨
赐	贝日ノ
桂	木圭一丨
刷	尸巾丨丨
聊	耳卯ㄋ丨
肝	月干一
捷	扌妻一ノ
喂	口田一
舱	舟仓ノ
啥	口舍ノ丶
唉	口厶ノ
磁	石䒑ㄋ
茫	落亡丶一
嫁	女宀一
乙	乙ㄋㄋ
嘿	口黑丨
瓜	瓜ノノ
菌	艹囗ノ一丶
丘	丘ノ丨
粹	米卒丶
催	亻山ノ丨
吩	口分ノ丶
披	扌皮ㄋノ
履	尸彳ノ一
乳	爫子ㄋ
煞	刍攵丶丶
廉	广兼丶ノ
兹	䒑幺ㄋㄋ
儒	亻雨一ノ
扯	扌止丨一
狐	犭瓜ノノ
姊	女弟
缠	纟广丨
伐	亻戈一
矮	矢禾ㄋ
绘	纟人一
姜	女ㄋノ
卿	卯ㄋ
斩	车斤ノ
穴	穴丶丶
肤	月夫
陛	阝比一
鹏	月月ノㄋ
肿	月中丨
辅	车甫一
肖	肖丨丶
沃	氵夭ノ一
巫	工从ノ
柄	木丙ノ丶
罩	罒卓丨
缴	纟白丶
潘	氵番ノ
蜂	虫夂一一
窝	穴呙丨
舌	舌ノ一一
晴	日青一一
隶	隶ㄋ一
悠	攸攵丶ㄋ
耕	耒井一一
郡	尹口ㄋ丨
爵	爫罒ㄋ
奸	女干一一
绳	纟口丨ㄋ
辨	辛丶
溃	氵贵丨ㄋ
婴	贝贝ㄋ
孝	耂子ㄋ
怖	忄丨
丫	丷丨丨
愁	禾火丶ㄋ
亭	亮丁一
携	扌隹ㄋノノ
泄	氵世一丨
疫	疒殳ノ
谭	讠覀丨ㄋ
翠	羽卒丶
霞	雨叚ㄋ
惹	艹丨ㄋ
酷	酉告ノ一
癌	疒口丨ㄋ
翰	人ㄋ丶
昂	日ㄋ
劈	辟刀ㄋ
甜	舌甘一丨
棉	木白丨
剥	录刂丨丨
卑	卑ノ丨
矣	厶矢ノ一
袍	衤勹ㄋ
轨	车九ノ
卜	卜丨丶
柯	木可一丨
吟	口今ノ
鞭	革亻一
宰	宀辛丶
脖	月孛ㄋ丨
俘	亻爫ㄋ丨
辱	辰寸一
尿	尸水丨ㄋ丶
莉	艹禾丨丨
咽	口因丨ㄋ
臭	自犬一
吻	口勿ノㄋ
疆	弓土一一
饱	饣勹ㄋ
抹	扌未一一
愣	忄罒丶一
凑	冫
芬	艹分ノ丶
朕	月䒑一
畏	田一ㄋ
骤	马耳ㄋ
禅	礻单丶
拾	扌合ノ丶
炉	火户丶
渴	氵曷丨ㄋ
铃	钅令ノ
妨	女方丶
填	土直ノ
豫	予象ノ
劣	小丿ㄋ
竭	立曷丨ㄋ
愉	忄俞ノ丶
摔	扌玄丶
览	监见丨ㄋ
顽	元页一
脆	月厃ㄋㄋ
吵	口小ノ
泡	氵勹ㄋ一
毅	立豕ノ
吊	口巾丨
扮	扌分ノ丶
狄	犭火丶
腔	月穴一
鹿	鹿丶一
遮	度灬丶ㄋ
肠	月汤ㄋ
灌	氵艹丨ㄋ
夕	夕ノㄋ
址	土止丨一
壳	壳几
氧	气羊丶ノ
屁	尸比一ㄋ
饶	饣尧一ㄋ
狭	犭夹ノ
摘	扌啇丶
芒	艹亡丶一
棋	木其一丨丶
讼	讠公ノ丶
杆	木干一一
翁	公羽ㄋ
倘	亻尚丨丶
胃	田⺝丨
拆	折丶丶
盒	合皿丨
驰	马也ㄋ丨
鲍	鱼勹ㄋ一ㄋ
纲	纟冈丨ㄋ
璃	王㐫丨ㄋ
艳	丰ㄋ
匪	匚非丨
蓄	艹玄丶
妄	亡女ㄋノ
姚	女儿丶
漏	氵尸一丨
秒	禾小ノ
柜	木匚ㄋ一
掏	扌勹ノ
函	了ㄋ丨
哎	口艹ノ丶
於	方人丶
裤	衤广一ㄋ
猴	犭亻ノ
枯	木古一丨
喉	口亻ノ
悦	忄总ノㄋ
痴	疒矢丨ㄋ
畜	玄田丨ㄋ
衫	衤彡ノ
寨	寒朩一丨
翅	十又ㄋ丶一
誓	折言丶
膀	月帝丶一
钦	钅欠ノ
纤	纟千ノ一
厨	厂豆一丨
撑	扌ノ一
宴	宀日ㄋ
锅	钅呙丨
涛	氵一丨
淮	氵隹ノ丨
盈	乃又丨ㄋ
胎	月台ㄋ丶
崩	山月ノㄋ一
拐	扌另丨
轩	车干一一
茨	艹次丶
盆	分皿
崖	山厂一丨
砸	石匚丨ㄋ
刹	乂朩丨丨
姬	女一
晕	日冖一
赚	贝兼丶
囊	橐吅一
凄	冫妻ㄋ
膜	月莫一
葬	艹歹ノㄋ
挽	扌免ノㄋ
耸	从耳一
脾	月卑ノ
诞	讠丿丨
懒	忄束ノ
妃	女己ㄋ
斑	王文一一
崔	山隹ノ丨
後	彳幺ノㄋ
嫂	女臼丨
颠	直八一ノ
棵	木日一丨丶
佐	亻一丨一
尉	尸示一丨
陡	阝走一丨
眨	目丿丶ㄋ
陀	阝宀ノ
陕	阝夹ノ丶
蜜	宀必丨ㄋ
饲	饣一
肺	月一丨
颈	轻页一ノ
眠	目民ㄋ一
喃	口十丨
撕	扌其ノ
驳	马爻ノ
摊	扌又ノ丨
朴	木卜丨
拘	扌句ノㄋ
酬	酉川丶
塑	屰月一
爪	爪ノノ丶
寇	宀元丨
岭	山令ノ
裕	衤谷ノ
僵	亻一丨ㄋ一
卵	卵ノㄋ丶
盼	目分ノ
赠	贝曾丶ノ
狮	犭一
逝	折辶丶ㄋ丶
藤	艹月丶
湘	氵相一
棍	木日一ㄋ
堵	土者一丨
歪	不正一
冻	冫东一
窃	穴七ㄋ
俯	亻广ノ丨
虹	虫工一
陌	阝百一
骄	马夭ノ丨
甫	甫一丨丶
盲	亡目丨ㄋ
姻	女因丨
畅	日丨ㄋノ
拓	扌石一ノ
啸	口肀ノ丶
猩	犭日ノ一
昭	日召ㄋ
抄	扌小ノノ
拱	扌共一丨
摧	扌山ノ丨
蓬	艹夂一一
菩	艹立丨ㄋ一一
铭	钅夕丨
浙	氵折一丨
洒	氵西一丨
氛	气分ノ
饥	饣几ノㄋ
踢	日ノ
璇	王族ㄋ丨
泊	氵白ノ丨
琼	王京丶一
锡	钅日ノ
滩	氵又ノ丨
捧	扌一一
讶	讠牙一ㄋ
咳	口亥丶一
嘱	口尸ノ丨
绵	纟白丨ㄋ
筒	冂一丨
冈	冈丨ㄋ
萍	落平一
挪	扌ㄋ丨
辟	辟ㄋ一丨
钩	钅勹ㄋ
歧	止十ㄋ丶
芝	艹之丶
谅	讠京丶一
逢	夂丰丶
鼎	目丨
廊	广朗ㄋ丨
吁	口于一一
栏	木兰丶ノ
巾	巾丨ㄋ丨
罕	冖八一
链	钅车丶
溪	氵爫ㄋㄋ丶
趟	走尚丨
坑	土亠ノㄋ
躯	身匚ノ丶
吏	同乂ノ
歉	兼欠ノㄋ
沾	氵占丨
妮	女尸ノㄋ
筋	月ㄋ
殷	彐ㄋ
棒	木一一
坠	阝人一
渊	氵丶
匠	匚斤ノノ
葡	芍甫一
耍	而女ㄋ
寡	宀丆丨
捏	扌日一丨
鸭	甲鸟ノㄋ
钉	钅丁一
冤	冖免丶
舟	舟ノノ
笨	木一一
瞎	目宀一一
辰	辰一ノ
瞒	目艹一
剪	前刀ㄋ
耻	耳止丨
漆	氵木ノ
阎	门ノ
骇	马亥丶一丶
擅	扌亠丨ㄋ一
孕	乃子ㄋ丨
诡	讠厃ㄋ
莎	落小ノ
昔	昔一丨一一
蠢	日丨ㄋ
宠	宀龙一ノ丶
谦	讠兼丶ノ
茅	艹矛ㄋ
淋	氵林一丨
账	贝长ノ
胶	月交丶
玑	王几ノㄋ
胀	月长ノ
庸	广肀ノㄋ
乞	乙ㄋㄋ
衙	彳五丨
媚	女丨
膝	月木ノ丶
逮	隶辶丶ㄋ
宛	宀夗ノ
翔	羽ㄋ
夷	大弓ㄋ一
骚	马又丶丨
荆	艹开丨丨
杭	木亠ノㄋ
裸	衤日一
乖	千北丨一
姨	女大ㄋ一
哑	口亚一
嚷	口襄丶
旺	日王一一一
恍	忄光丨
叉	又丶丶丶
惶	忄白一
镖	钅覀一一
咒	吅几ノㄋ
亨	亨丶一丨
窜	穴口丨
杖	木一ノ丶
蝶	虫世一丨
逸	免丶丶
恕	女口丶
搏	扌甫一丨丶
焰	火ノ丨
绣	纟禾ㄋノ
禧	礻壴丨ㄋ一
淫	氵爫ノ一
丐	一⺊ㄋㄋ
碑	石卑ノ
鹅	我鸟ノ
蒲	落甫一丨丶
阐	门单丶
轿	车夭ノ丨
伞	人丷一
蔽	艹敝丶
咐	口付ノ丨
兆	儿丶一丶
爽	大爻ノ
豹	豸勹丶丶
弦	弓玄丶一
薪	艹立一丨丨
冥	冖日丶
捐	扌口丨ㄋ一
谎	讠艹丶
愧	忄鬼ノ丨
衷	亠中ノㄋ
倏	攸夂一ノ
猿	犭吉ノ
哇	口圭一
粘	米占丨
栽	木一丨
浦	氵甫一丨
掀	折欠ノㄋ
脂	月旨ノㄋ
嘲	口ノ
框	木匚一一
矩	矢匚ㄋ一
龟	日ㄋ
叠	又双丶
谊	讠宀丨ㄋ
脊	人丨ㄋ
刮	舌刂丨丨丨
哨	口肖丨
兔	免丶丶丶
娶	耳又ㄋ
聘	耳由一
慨	忄一
俺	亻大丨ㄋ
嗓	口又ㄋ丶
舅	臼田ㄋ
寓	宀禺丨
戚	戊上丨
仑	人匕ノㄋㄋ
恳	艮心丶ㄋ
瘤	疒留丨ㄋ
掘	扌尸ㄋ丨
浴	氵谷ノ丶
倡	亻日丨ㄋ一
裹	亠日一丨
渠	氵匚ㄋ
钓	钅勹丶
圳	土川ノ
涵	氵了丶
泼	氵发ㄋノ
窄	穴乍ノ一
瓷	次瓦一
祈	礻斤ノノ
拂	扌弓ノ丨
巢	巛日一
贞	⺊贝丨
纱	纟小ノ
绑	纟ㄋ丨
茂	艹戊一ノ
砖	石专一
谱	讠並丨
坟	土文丶一
噢	口向丶ノ
硕	石页一
侄	亻至一ㄋ
蹲	酋一
甩	月乚
匈	勹乂ㄋ丨
躬	身弓ㄋ一
胳	月各ノㄋ
徽	微糸ㄋㄋ
邵	召阝ㄋ丨
蜀	罒勹丨ㄋ
篮	监丨
竖	坚立丶
颁	分页一ノ
焉	正与丶
壶	壳业丨
浸	氵彐丶ㄋ
萄	芍缶ノ
僚	亻尞一ノ
玫	王攵ノ一
桓	木一丨
攀	木爻一丨
撰	扌巳ㄋ一
旬	勹日丨ㄋ
媳	女自丶ㄋ
嘻	口壴丨
蒸	艹丞丶
裙	衤尹丨ㄋ
滥	氵监丨ㄋ一
愕	忄吅一
讽	讠风ノ
霜	雨相一丨
诏	讠召ㄋ
躁	口丨
厘	厂里丨ㄋ一
憾	忄咸丶ㄋ
帘	穴巾丨ㄋ
巷	共巳ㄋ一
溶	氵宀ノ
勋	口贝ㄋノ
晰	日木ノノ
亩	亠田丨ㄋ
滞	氵带一丨
舆	𦥑车一ノ
咸	咸一ノ
衔	彳钅一
邱	丘阝ㄋ
挫	扌从一丨
桩	木广一丨
搁	扌门ノ
雀	小隹ノ
辣	束一丨
诧	讠宀ノ一
哗	口华ノㄋ
屡	尸米ㄋノ
喻	口俞ノ丶丨
窑	穴缶ノ
踩	爫一丨
鸦	牙鸟ノ
郊	交阝ㄋ
株	木丿一一
秃	禾几ノㄋㄋ
厦	厂丆丨
禄	礻录ㄋ一
卒	卒丶一
丸	九丶丶丶
聂	耳双ㄋ丶
雁	厂亻ノ丨一
琳	王林一
虏	虍力ㄋ
汝	氵女ㄋノ
肢	月十ㄋ
咕	口古一丨一
耽	耳冖ノ
咖	口加ㄋ
煌	火白一一
肆	镸聿ㄋ一
哄	口共一丨
弊	敝廾一ノ
耿	耳火丶ノ
叮	口丁一丨
倦	亻ㄋ
腺	月白丨
彪	虍几ノノ
鹤	冖隹ノ
尴	尢监丨ㄋ
巩	工凡ノㄋ
焚	林火丶ノ
饼	饣䒑一
鄙	口十丨ㄋ
拢	扌龙一
瞄	目艹丨ㄋ
勿	勿ノㄋノ
菊	芍米丶
厢	厂相一丨
腕	月宀ノㄋ
斋	文而一ノ
诈	讠乍ノ
呜	口乌ㄋ
怯	忄去一丨
铸	钅一
诀	讠夬ㄋ
绢	纟口丨ㄋ一
魄	白鬼ノ
婉	女宀ノㄋ
兜	白𦥑ノㄋ
涅	氵日一丨
禀	亠回一一
驴	马户丶
垄	龙土一丨一
擒	扌人丶一
囚	囗人ノ丶丶
捞	扌劳ㄋノ
舶	舟白ノ丨
倚	亻大一丨
喀	口宀ノㄋ丶
贱	贝戋一一丶
稣	鱼禾ノ
冀	北田
厄	厂㔾ㄋㄋ
溢	氵䒑ノ丶
炭	山丶ノ
稽	禾尢丶
渗	氵叁ノノ
罐	缶艹丨ㄋ一
泣	氵立丶一
螺	虫田ㄋ
衍	彳氵一一
狡	犭交丶
桶	木甬ㄋ丶
塌	土日ㄋ
卸	止ㄋ丨
嘶	口其ノノ
帆	巾凡
侨	亻夭ノ丨
逗	豆辶丶ㄋ
昧	日未一一
蓦	莫马ㄋㄋ
坎	土欠ノㄋ
棺	木宀丨
荐	艹在ㄋ丨
雌	此隹ノ
棚	木月ノ
靖	立青一一一
裴	非衣丶
栖	木西一
钧	钅勹丶一
贩	贝ㄋ丶
啡	口非丨一
衬	衤寸一
兑	总儿ノ
榜	木帝丶一ノ
魁	鬼⺀一
谜	讠米丶
毙	比歹ノㄋ
麽	麻丿ㄋ丶
瞥	敝目丨ㄋ
纺	纟方丶
掷	扌䒑一ノ
肾	坚⺝丨ㄋ
烛	火虫丨ㄋ丶
锻	钅段ノ
谬	讠羽ノ
芦	艹户丶ㄋ
膨	月壴ノ
珊	王冂丨ㄋ一
刃	刀丶丶丶
隙	阝小丨ㄋ丶
嫩	女束ノ
垒	厶厶ㄋ
钥	钅月ノ
塘	土广ㄋ一
韵	音勹丶一一
旱	日干一一
喇	口束丨丨
咨	次口丨ㄋ
驼	马宀ノㄋ
颂	公页一ノ
譬	辟言丶一
尹	尹ㄋ一ノ
傍	亻帝丶一
坊	土方丶
哟	口纟ノㄋ
霉	雨每ノ
忖	忄寸一丨丶
苹	艹平一
佣	亻用ノㄋ丨
搂	扌米ㄋノ
堤	土是丨
怡	忄台ㄋ丶
谍	讠世一
淘	氵勹ノ
藩	落番ノ
贬	贝丿丶ㄋ
斧	父斤ノノ
糕	米羊丶
颖	匕禾一
俞	俞ノ丶丨
砰	石平一丶
稻	禾爫ノ丨一
熙	巳丶
盏	戋皿丨
棠	木一丨
黯	黑音丶
襄	襄丶一丶
烤	火耂一ㄋ
詹	厃八丶一
煮	者灬丶
魅	鬼未一一
蕴	艹纟丨ㄋ一
骆	马各ノㄋ
谐	讠比ノ丨
谕	讠俞ノ丶
捆	扌囗一
剿	巛日一丨
轴	车由丨ㄋ
枕	木冖ノㄋ
笛	由丨ㄋ一
挟	扌夹ノ丶
逾	俞辶丶ㄋ
咧	口歹丨
斌	文一一ㄋ
捡	扌佥ノ丶
壤	土襄丶一
黛	代黑丨ㄋ
沼	氵召ㄋノ
辐	车同丨ㄋ一
淑	氵上丨ノ
娱	女口一
弘	弓厶ㄋ丶
窦	穴十ㄋ丶
淹	氵大丨ㄋㄋ
呐	口内丨ㄋ
灿	火山丨ㄋ
迦	加辶丶
绅	纟日丨
禽	人㐫丨
犬	犬一ノ丶
倩	亻青一一
彦	产彡ノ
伽	亻加ㄋノ
蹄	帝丨
枢	木区一ノㄋ
啪	口扌ノ丨
妾	立女ㄋ
搅	扌学丨ㄋㄋ
汁	氵十一丨丨
羡	次丶
凛	冫亠丨
伺	亻一丨
蚁	虫丶ノ丶
剖	立口丨
幢	巾立丨
绞	纟交丶
瞅	目禾丶
俏	亻肖丨
娟	女口丨ㄋ
奢	大者一丨
膊	月甫一丨
谴	讠中一丶
丙	丙人ノ丶
滨	氵宀ノ丨
窥	穴夫丨ㄋ
斐	非文丶一
祷	衤一丨
藉	艹耒一丨
敞	尚攵ノ
厮	厂其ノノ
凰	几白一一
咯	口各ノㄋ
顷	页一ノ丶
沸	氵弓ノ丨
绸	纟冂一丨
莹	劳王丶
椎	木隹ノ
垫	执土一
廖	广羽ノ
捣	扌丨ㄋ丨
叩	口卩ㄋ
蜡	虫昔一丨
侮	亻每ノ
眸	目厶ノ
逛	犭王丶ㄋ
芙	艹夫一一
炒	火小ノノ
谣	讠爫ノ
沫	氵未一一丶
咋	口乍ノ一
屯	屯一ㄋ
屑	尸肖丨丶
瑰	王鬼ノ
峻	山夋ㄋ
喧	口㝉丨
晒	日西一
莽	艹犬一ノ丨
矢	矢ノ一
龚	龙共一丨
熬	敖灬丶丶
撇	扌敝丶ノ
梳	木㐬丶一
醇	酉享丶一
辜	古辛丶
迄	乙丶
匙	是匕ノㄋ
嫉	女疒ノ
睹	目者一丨一
镑	钅帝丶
诵	讠甬ㄋ
痒	疒羊丶ノ
嗅	口自一ノ
栗	覀木一丨丶
颊	夹人一ノ
缅	纟丆丨
缚	纟甫一丨丶
樱	木贝丨
妒	女户丶ㄋ
麟	鹿米ノㄋ
逍	肖辶丶ㄋ
潭	氵覀丨ㄋ丨
芯	艹心丶ㄋ
郝	赤阝ㄋ丨
蛛	虫丿一一
堕	阝ノ
凳	登几ノㄋㄋ
揉	扌矛一丨
婢	女卑ノ
梭	木夋ㄋ
虞	虍口一一
嗣	口一
垃	土立丶
妓	女十ㄋ丶
勘	其乚ㄋノ
篷	夂一
乍	乍ノ一
桐	木冂一丨
缕	纟米ㄋノ
叱	口七ノㄋㄋ
鲸	鱼京丶一
贿	贝丨ㄋ一
趴	八ノ丶
朽	木丂一ㄋ
奎	大圭一丨
钞	钅小ノノ
磕	石去丨ㄋ一
瑶	王爫ノ一
隋	阝一丨
憎	忄曾丶ノ
蔑	萝戊丶
馨	士ノㄋ
杏	木口丨
栋	木东一ㄋ
昼	尺旦丨
苟	艹句ノㄋ
腥	月日ノ一
萝	萝夕ノㄋ丶
弩	奴弓ㄋ
碌	石录ㄋ
寝	宀丬ㄋ一
倭	亻禾ㄋノ
垮	土大一一
岚	山风ノㄋ
燥	火口丨ㄋ丶
姥	女耂ノ
沦	氵人ノㄋ
兀	兀一ノ
铅	钅几丨ㄋ
砂	石小ノノノ
兮	八丂一ㄋ
牟	厶牛ノ一
哉	口丨ㄋ一
浆	奖水丨ㄋ
虐	虍一
嗡	口公ㄋ丶
旷	日广丶一
沮	氵且丨ㄋ
帖	巾占丨
鳞	鱼米ノㄋ
诛	讠丿一一
涯	氵厂一丨一
遁	十丨ㄋ丶
澄	氵登ㄋ
锤	钅垂ノ
滔	氵爫ノ丨
寞	宀莫一丨
妆	丬女ㄋノ一
蹦	山ノㄋ
阮	阝元一
募	莫力ㄋノ
敷	甫方ノ一丶
眯	目米丶
汹	氵乂ㄋ
嘟	口者ㄋ
霆	雨壬ㄋ
褐	衤曷丨ㄋㄋ
畴	田一丨丶
蚕	天虫丨ㄋ
奠	酋大一ノ
嚼	口爫丨ㄋ
榴	木留丨ㄋ
拙	扌出ㄋ丨
蚀	饣虫丨ㄋ丶
荫	艹阝ノ
鸽	合鸟ノㄋ
咦	口大ㄋ一
甸	勹田丨
吱	口十ㄋ丶
泌	氵必丶ㄋ
暮	莫日丨ㄋ
挠	扌尧一ㄋㄋ
叭	口八ノ丶丶
灶	火土一丨
蓉	艹宀ノ丶
峨	山我ノ一
菱	艹土ノ丶
稚	禾隹ノ
澡	氵口丨ㄋ丶
蔓	艹日丨
泻	氵冖一一
裘	求衣丶一
溅	氵贝一一
丞	丞ㄋ丨
秉	禾彐ㄋ一
遏	曷辶丶ㄋ丶
绒	纟戈一
彬	林彡ノノ
熄	火自丶ㄋ
朦	月劳一一
琢	王豕丶
膏	亮口丨
泳	氵永丶ㄋ
凿	业ㄋ丨
敛	佥攵ノ
庐	广户丶
惭	忄车ノノ
畔	田半丶ノ
沧	氵仓ノ丶ㄋ
酿	酉良丶
阀	门亻一ㄋ
虔	虍文丶一
侣	亻口丨
匀	勹冫丶一
拯	扌丞ㄋ丨
莺	劳鸟ノㄋ
屿	山与一
沪	氵户丶ㄋ
叟	臼丨ㄋ
藻	落口丨ㄋ
雍	亠乡ノ丨
瘫	疒又ノ丨
蹈	爫ノ
揽	扌监丨
豁	宀丰丨ㄋ一
氢	气轻ㄋ丶一
骸	骨亥丶一
陋	阝丙ノ丶
捂	扌五丨ㄋ
冶	冫台ㄋ
懈	忄角ㄋ
坪	土平一丶
蔬	艹丶
翘	尧羽ㄋ丶
嘎	口丆丨
缔	纟帝丨
钮	钅丑ㄋ
娥	女我ノ一
讥	讠几ノ
晤	日五丨
灼	火勹丶
舵	舟宀ノㄋ
纬	纟韦一一
圾	土及ノㄋ丶
澜	氵门一丨丶
茎	艹轻ㄋ
鄂	吅亏ㄋ
歹	歹一ノ丶
邹	刍阝ㄋ丨
枉	木王一一
琉	王㐬丶一
跋	ㄋ
庇	广比一ㄋ
杉	木彡ノ
梢	木肖丨
戳	羽隹一ㄋ
蝉	虫单丶
毯	毛炎丶ノ
萎	艹禾ㄋ
裳	衣丶
绰	纟卓丨
佑	亻丨
狸	犭里丨ㄋ一
拚	扌厶一ノ丨
窟	穴尸ㄋ丨
硫	石㐬丶一
腻	月弋一一
憋	敝心丶ㄋ
凹	凹丨ㄋ一
赎	贝十ㄋ丶
崎	山大一丨丨
烁	火丨
嚣	吅页丨ㄋ
焕	火丨
暑	日者一丨一
扛	扌工一丨一
匕	匕ノㄋㄋ
揣	扌山一
凸	凸丨一
怠	台心丶
觅	爫见丨
呕	口区一ノ
孽	艹丶一
楞	木罒丶一
矫	矢夭ノ丨
潇	氵艹ㄋ一
簇	族ノ
浇	氵尧一ㄋ
绥	纟爫ㄋ
枣	朿⺀
芽	艹牙一ㄋ
蝇	虫口丨ㄋㄋ
僻	亻辟ㄋ
榻	木日ㄋ
沐	氵木一丨
宦	宀臣一
毋	毋ㄋㄋ
碟	石世一
仕	亻士一丨
戎	戈一ノ
呻	口日丨丨
啼	口帝丨ㄋ丨
虾	虫下一丨
樊	木爻一丨丶
萌	艹日ノㄋ
棕	木宀一一
嫣	女正一
伶	亻令ノ丶
鞘	革肖丨
删	冂冂一丨
嵌	山甘ノ
暇	日叚ㄋ
蛟	虫交丶
茵	艹因丨
驯	马川ノ丨
炕	火亠ノㄋ
碳	石山一
烫	氵汤丶
咚	口夂丶丶
苑	艹夗ノ
蚂	虫马ㄋ
厥	厂屰ノ
雯	雨文丶
慷	忄广ㄋ
赦	赤攵ノ一丶
旭	九日丨
煎	前灬丶丶
惕	忄日ノㄋ
颓	禾几一
坝	土贝丨ㄋ
悍	忄日一一
匿	匚艹一ノ
噪	口口丨ㄋ丶
涡	氵呙丨
禹	禹ノ丨
敝	敝丶ノ丶
簿	氵一丨
缸	缶工一丨
坤	土日丨丨
琐	王丨ㄋ
蚊	虫文丶
粟	覀米丶ノ丶
诫	讠戈一
髓	骨一丨
梵	林凡ノㄋ丶
溯	氵屰ノ
蝴	虫古ノㄋ
涩	氵刀丶丶
尬	尢人ノ丨丨
揪	扌禾丶
窘	穴尹丨
盔	火丨ㄋ
棘	朿朿一丨
婶	女宀丨ㄋ
喔	口尸一ㄋ
踱	度ㄋ丶
嗜	口耂ノㄋ
啤	口卑ノ丨
哺	口甫一
奕	亦大一ノ
淳	氵享丶一
镶	钅襄丶一
晌	日向丨ㄋ
铲	钅产丶
粪	米共一丨丶
瑜	王俞ノ
唾	口垂ノ一一
冢	冖豕丶
庵	广大丨ㄋ
扼	扌厂ㄋㄋ
聋	龙耳一
庚	广彐ノ丶
膛	月一丨
疤	疒巴ㄋ
叨	口刀ㄋノ
佟	亻夂丶丶
绷	纟月ノ
棱	木土ノ丶
筷	忄ㄋ一
慑	忄耳ㄋ丶
庶	度灬丶丶丶
沁	氵心丶ㄋ丶
渺	氵目丨ノ
迂	于辶丶ㄋ丶
梨	禾刂一丨
拣	扌练一ㄋ
葫	艹古ノㄋ
浏	氵文丨丨
橡	木象ノ
扳	扌ㄋ丶
嘘	口虍丨丨
牡	牜土一丨
贮	贝㝉丶丶
窍	穴工一
襟	礻林一
眷	目丨
弧	弓瓜ノノ
癫	疒直ノ丶
葱	艹勿丶
熏	千黑丨ㄋ
噗	口业丶
炯	火冂丨
稼	禾宀一ノ
鞠	革勹丶ノ
栅	木冂ノ
朔	屰月ノㄋ
霎	雨立ㄋ
匣	匚甲丨ㄋ
厕	厂贝丨丨
眩	目玄丶
岔	分山丨ㄋ
缆	纟监丨
谏	讠柬一
呃	口厂ㄋㄋ
唔	口五丨ㄋ一
斟	其乚丶丶
懿	壳豆丶一
拧	扌宀一丨
磅	石帝丶
嗤	口蚩ㄋ
尧	尧一ㄋㄋ
鳍	鱼耂ノㄋ
肘	月寸一
帜	巾口ノ
晦	日每ノ
搓	扌一丨一
粥	弓米ㄋ一
枫	木风ノ
琪	王其一丨丶
裔	衣冏丨ㄋ一
彰	音十ノノ
瞻	目厃ノ
邑	口巴ㄋ丨
吭	口亠ノㄋㄋㄋ
垣	土一丨
嗽	口束ノㄋ
皓	白告ノ
竿	干一一
嚎	口亮一ノ
拽	扌曳丨ㄋ
倪	亻臼ノㄋ
胧	月龙一ノ
峭	山肖丨
攸	攸攵ノ一丶
瓣	辛瓜丶一
忿	分心丶ㄋ丶
扒	扌八ノ丶丶
嘀	口啇丶一
桨	奖木一丨
锥	钅隹ノ
梗	木更一丨
蹬	登ㄋ
夭	夭ノ一
俭	亻佥ノ丶一
淌	氵尚丨
廓	广享ㄋ
浊	氵虫丨ㄋ丶
碱	石咸一ノ
迭	丿夫丶ㄋ
逞	口王丶ㄋ
讳	讠韦一一
邸	氏丶ㄋ
檀	木亠丨ㄋ
磷	石米ノㄋ
撼	扌咸丶ㄋ
踉	良丶ㄋ
娅	女亚一
绽	纟定丶丶
哆	口夕ノㄋ丶
诬	讠工ノ
靴	革亻ノㄋ
芸	艹云一一
冉	冉丨ㄋ一
宵	宀肖丨
奚	爫幺一ノ
戟	戈一
札	木乚ㄋㄋ
蛙	虫圭一丨
沛	氵一丨ㄋ
擎	艹句ノ一丨
硝	石肖丨
崛	山尸ㄋ丨
槽	木曹一丨
喽	口米ㄋ
礁	石隹丶丶
哮	口耂ㄋ丨
腮	月田丶
蜘	虫矢丨
妞	女丑ㄋ
刁	一一一一
栓	木人一一一
熔	火宀ノ丶
懊	忄向丶
侥	亻尧一ㄋ
炽	火口ノ
铮	钅争ノ
鞑	革大丶ㄋ
胚	月不一一
迸	䒑廾丶
苛	艹可一丨
敖	敖一一丶
轼	车弋一丨
祁	礻阝ㄋ丨
拇	扌母ㄋㄋ
邢	开阝ㄋ丨
窒	穴至一
酌	酉勹丶丶
柬	柬一
悼	忄卓丨一
瑛	王艹丨ㄋ
掐	扌ノ丨
颐	页一
猝	犭卒丶
缀	纟双ㄋ丶
锣	钅罒ノㄋ
饷	饣向丨ㄋ
卦	圭卜丨
絮	女口ㄋㄋ丶
壕	土亮一ノ
噬	口一丨丶
崭	山车ノノ
馈	饣贵丨
霄	雨肖丨丶
荀	芍日丨
岑	山今ノ丶
褚	衤者一丨一
墅	里予一
墟	土虍丨丨
殆	歹台ㄋ
涕	氵弟丶
骏	马夋ㄋ丶
矗	直直一丨一
徘	彳非丨
幡	巾番ノ
釉	丿米丨
嗔	口直ノ丶
煽	火户ㄋ丶
醋	酉昔一丨
匡	匚王一一一
鞍	革宀ㄋ
袜	衤未一一丶
寥	宀羽ノ丶
槐	木鬼ノ丨
罡	罒正一
茜	艹西一丨
挚	执手ノ一
缎	纟段ノ丨
薇	艹微ノㄋ
闺	门圭一丨一
湛	氵其ㄋㄋ
悯	忄门丶
咆	口勹ㄋ
毓	每㐬丶一
颅	⺊尸一ノ
摹	莫手ノ一
陇	阝龙一ノ
钙	钅一丨一
唬	口虍ノㄋㄋ
缪	纟羽ノ丶
酱	奖酉一丨
痰	疒炎丶ノ
锯	钅尸一丨
炫	火玄丶一
霹	雨辟ㄋ一
杠	木工一
懦	忄雨一ノ
忒	弋心丶ㄋ
笃	马ㄋ
翩	户ㄋ
檐	木厃ノ丶一
婿	女疋丨ㄋ
搀	扌免丶丶
肋	月力ㄋ
垦	艮土一丨一
蟹	角刀ノ
汰	氵大丶丶
捅	扌甬ㄋ丶丨
箫	肀ノ丨
拴	扌人一一
羌	乚ㄋㄋㄋ
绊	纟半丶ノ丨
嗦	口孛ㄋㄋ
洽	氵合ノ
瀑	氵日一丨丶丶
珀	王白ノ丨一
绎	纟又一
驿	马又一一
恃	忄土一丨丶
蟒	虫艹一ノ
撩	扌尞一ノ
掳	扌虍ㄋノ
抒	扌予ㄋ丶
芭	艹巴ㄋ
犀	尸氺ノ一
舷	舟玄丶一丶
甄	覀土一ㄋ
臀	尸共ノㄋ
橱	木厂一丨丶
睦	目土ノ丶一
嫦	女丨ㄋ丨
拎	扌令ノ丶丶
娴	女门一丨
粤	向米一ㄋ
蕊	艹心丶ㄋ丶
辫	辛纟丶一
酋	酋丶ノ
狞	犭宀一
踌	一丨
诅	讠且丨
坞	土乌ㄋ一
渣	氵木丨ㄋ
亥	亥丶一丶
巍	山禾ㄋノ
靡	麻非丨一
瘟	疒日丨ㄋ一
瞿	目目ノ丨
陨	阝口丨
惫	夂田丶ㄋ
脯	月甫一丨丶
骷	骨古一丨
肪	月方丶一
祠	礻一丨
祀	礻巳ㄋ一
揖	扌口一丨
剔	日勿丨
膳	月羊丶ノ
叽	口几ノㄋ
钝	钅屯一ㄋ
缉	纟口一丨
狙	犭且丨ㄋ
靶	革巴ㄋ
徊	彳回丨ㄋ
疮	疒仓ノ丶
氯	气录ㄋ一
蔚	艹尸一
鹃	口⺝ノㄋ
啃	口止丨ㄋ一
皂	白七一ㄋ
阙	门屰ノㄋ
鲤	鱼里丨ㄋ
峙	山土一丨
氨	气宀ㄋ
禺	禺丨ㄋ
舔	舌天丨
骡	马田ㄋ
闽	门虫丨ㄋ
秽	禾山ノ
闵	门文丶一
咙	口龙一ノ丶
瑚	王古ノㄋ一
嬉	女壴丨
拭	扌弋一丨
肮	月亠ノㄋㄋ
佬	亻耂ノㄋ
狩	犭宀一丨
紊	文糸ㄋㄋ
咎	夂卜丨ㄋ
栈	木戋一一丶
嗨	口氵ノ一
殉	歹勹丨ㄋ
幌	巾日丨丶
苔	艹台ㄋ
嵩	山高丶
篱	㐫丨ㄋ丶
剃	弟刂丨丨丨
氓	亡民ㄋ一
婷	女亮一丨
昊	日天一一
砌	石七ㄋノ
绫	纟土ノ丶
佯	亻羊丶ノ丨
悖	忄孛ㄋ丨
巳	巳ㄋ一ㄋ
炳	火丙ノ丶
呛	口仓ノ丶
濒	氵止丨ノ
瞟	目覀一一
汀	氵丁一丨丨
屎	尸米丶ノ
孜	孑攵ノ一
嵋	山丨ㄋ
犁	禾刂ノ一
揍	扌ノ一
苇	艹韦一一
掺	扌叁ノノ
趾	止丨一
酶	酉每ノ一
榆	木俞ノ丶
霖	雨林一丨
拷	扌耂一ㄋ
韧	韦刀丶
侈	亻夕ノㄋ
饵	饣耳一
肇	户攵ㄋ
舜	受舛ノ
兢	古儿一
臻	至ノ一丶
猾	犭骨丨ㄋ
擂	扌雨丨ㄋ一
恤	忄丿丨ㄋ
隘	阝䒑ノ
忏	忄千ノ
蝗	虫白一
颔	今口一ノ
绮	纟大一丨
琦	王大一丨丨
诩	讠羽ㄋ
钗	钅又丶
茄	艹加ㄋ
敕	束攵ノ一
睿	⺊冖一
跺	几一丨
噜	口鱼丨ㄋ
佃	亻田丨
颉	吉页一ノ
戮	羽㐱一ㄋ
铀	钅由丨
倔	亻尸ㄋ丨
蕉	艹隹丶
溺	氵弓丶一
褂	衤圭丨丶
谟	讠莫一丨丶
皖	白宀一
狈	犭贝丨ㄋ丶
噩	王口丨ㄋ
糙	米告丶
瘾	疒阝ノㄋ
赁	亻壬丨ㄋ
埔	土甫一丨
咄	口出ㄋ
畸	田大一丨丨
赣	音十ノㄋ
樵	木隹丶丶
亢	亠几ノㄋ
侃	亻口ノ
嫡	女啇丶一
眶	目匚一一
鸠	九鸟ノ
涤	氵夂一丨丶
捻	扌今丶ㄋ丶
捍	扌日一一
芜	艹一一ノ
酥	酉禾ノ
眺	目儿丶
屉	尸世一丨ㄋ
抿	扌民ㄋ一
辙	车丨ㄋ
胤	丿幺丨ㄋㄋ
闸	门甲丨ㄋ
蛊	虫皿丨
鳌	敖鱼ノㄋ
彷	彳方丶一
褪	衤艮丶
翎	令羽ㄋ丶
婪	林女ㄋノ
衅	丿皿丶ノ
猖	犭日丨ㄋ
捶	扌垂ノ一一
伎	亻十ㄋ丶
梧	木五丨
洼	氵圭一丨一
吆	口幺ㄋㄋ
瞳	目立丨ㄋ
勺	勹丶丶丶
椒	木上丨
卉	十廾一ノ丨
竺	二一一
嗖	口臼丨
淀	氵定丶丶
痪	疒丨ㄋ
烘	火共一丨丶
炊	火欠ノㄋ丶
枭	木一
髦	髟毛ノ
轧	车乚ㄋㄋ
矶	石几ノㄋㄋ
钳	钅甘一丨一
稠	禾冂一丨
戊	戊一ノ丶丶
羁	罒革ㄋ
璋	王音一丨
咪	口米丶ノ丶丶
甭	不用ノㄋ
颌	合页一ノ
铝	钅口丨ㄋ一
谒	讠曷丨ㄋ
麾	麻毛ノ一
驭	马又ㄋ丶
俨	亻亚ノノ
疚	疒久ノㄋ
侬	亻农丶ㄋ
晏	日宀ㄋ
驮	马大一ノ丶
憔	忄隹丶丶
烙	火各ノ
赃	贝广一丨一
怅	忄长ノ一
搔	扌又丶
篡	目一ノ
磋	石一丨一
蹙	戊上丨ノ
毗	田比一ㄋ
瞩	目尸ノ丨
笠	立丶一
殴	区殳ノㄋ
唠	口劳ㄋノ
喳	口木丨ㄋ一
锄	钅且ㄋノ
隧	阝㒸丶ㄋ
剌	束刂丨丨
菁	艹青一
憨	敢攵丶
狰	犭争ノ
桔	木吉一丨一
孵	卵爫ㄋ丨
袅	衣丶一
蝠	虫同丨
滇	氵直ノ丶
黝	黑幺ㄋ
疹	疒㐱ノ丶
缰	纟一丨ㄋ
汴	氵丶一丨丶
酝	酉云一一
焘	寸丶
垢	土一丨
掣	巾丨丨
嘈	口曹一丨
琅	王良丶ㄋ丶
筛	一
谤	讠帝丶
曙	日罒一丨
蕾	艹雨丨ㄋ
漱	氵束ノㄋ
阱	阝井一
琵	王王一ㄋ
胰	月大ㄋ一
狒	犭弓ㄋ一
哽	口更一丨丶丶
廿	廿一丨一一
呸	口不一一
蠕	虫雨一
睫	目妻丨一
筐	匚一一一
吠	口犬一
讪	讠山丨ㄋ丨
赂	贝各ノㄋ一
汲	氵及ノㄋ丶
惺	忄日ノ一
酣	酉甘一丨一
澈	氵丨ㄋ
滤	氵虍丶ㄋ
徙	彳止丨一丶
抡	扌人ノㄋ
惋	忄宀ノ
漩	氵族ㄋ丨丶
孰	享九丶丶
睬	目爫一
哧	口赤一丨丶
钵	钅木一
椭	木阝一
笈	及ノㄋ
茹	艹女丨
褒	亠华丨ㄋ
蛾	虫我ノ
衲	衤内丨
啧	口丨ㄋ丶
澎	氵壴ノノ
毡	毛占丨一
窖	穴告ノ
荧	劳火丶ノ丶
曳	曳丨ㄋ
吝	文口丨ㄋ一一
跄	仓ㄋㄋ
谛	讠帝丨ㄋ
淆	氵㐅一ノ
诣	讠旨ノㄋ
菇	艹女一丨
锈	钅禾ㄋ
辗	车尸一丨
穗	禾惠丶ㄋ
惰	忄一丨
鲨	氵小ノノ一
柿	木亠丨ㄋ丨
脓	月农丶
巅	山直ノ丶
簧	丨ㄋ
帷	巾隹ノ丨一
啄	口豕丶
娄	米女ㄋ
萤	劳虫丨
琛	王冖ノ丶丶
奄	大日ㄋ
盎	央皿丨
渭	氵田丨ㄋ
馒	饣日丨ㄋ
硅	石圭一丨一一
攘	扌襄丶一
鸾	亦鸟ノㄋ
忡	忄中丨ㄋ
嫖	女覀一一
蝎	虫曷丨
虬	虫乚
鹦	贝贝ㄋノ
桅	木厃ㄋㄋ
贻	贝台ㄋ丶
鞅	革央丨ㄋ丶
咀	口且丨ㄋ一
惚	忄勿丶ㄋ丶
翟	羽隹ノ丨
钊	钅刂丨
拈	扌占丨一
痊	疒人一一
沌	氵屯一ㄋ
攒	扌先ノ一
髯	髟冉丨ㄋ一
烹	亨灬丶丶丶
豚	月豕一ノ
镕	钅宀ノ
咏	口永丶ㄋ
渎	氵十ㄋ丶
诘	讠吉一丨一
腑	月广ノ丨
悚	忄束一
撮	扌日一丨丶
觑	虍业丨ㄋ
寅	㝉由ノ丶
磊	石石一ノ
茸	艹耳一
忱	忄冖ノㄋ
傀	亻鬼ノ丨
亵	亠执ノㄋ丶
疙	疒ㄋ
匾	匚户丨ㄋ丨
弛	弓也ㄋ丨
雏	刍隹ノ丨
戍	戊丶丶
弼	弓百ㄋ
帛	白巾丨ㄋ
缭	纟尞一ノ
羹	灬丶ノ
迥	冂口丶
袄	衤夭ノ一
躇	艹一
俟	亻厶ノ一
墩	土享ノ一
痉	疒轻ㄋ丶
鸥	区鸟ノㄋ
阜	十一丨
抨	扌平一丶
禾	禾ノ一
曝	日日一
壬	壬ノ一一
乒	丘丿ノ
伢	亻牙一ㄋ
孚	爫子ㄋ丨
隅	阝禺丨
堑	车斤一丨一
恪	忄各ノㄋ一
槛	木监丨
驹	马句ノㄋ
薯	萝者一丨
惦	忄广丨一
怦	忄平一丶
炙	火丶ノ
恺	忄山ㄋ一
蒜	艹示一
坍	土丹ノ
铠	钅山ㄋ一
韶	音召ㄋノ
咔	口上丨丶
璧	辟王丶
驸	马付ノ丨
嗒	口艹ノ丶一
霓	雨臼ノ
彝	彑米ㄋ
淤	氵方ノ丶
抉	扌夬ㄋ一
挛	亦手ノ一
捎	扌肖丨丶
呱	口瓜ノノ
袱	衤亻一ノ
惘	忄冂丶ノ
蹑	耳ㄋ
糜	麻米丶
蹿	穴丨
桀	舛木一
聆	耳令ノ丶
褥	衤辰一丨
阑	门柬一
貂	豸召ㄋノ
蹭	曾丶
梓	木辛丶一丨
俾	亻卑ノ丨
漪	氵犭一ノ
矜	矛今ノ丶
漓	氵㐫丨ㄋ
穹	穴弓ㄋ一ㄋ
诽	讠非丨一
圭	圭一丨一
诃	讠可一
肛	月工一丨一
蔼	艹讠丨ㄋ
蕃	艹番ノ
鬓	髟宀ノ丨
辄	车耳ㄋㄋㄋ
恻	忄贝丨丨
阉	门大丨ㄋㄋ
崽	山田丶
刨	勹巳丨丨
瓢	覀示ノノ
祟	出示一一
幔	巾日丨ㄋ
沽	氵古一丨一
笋	尹ㄋ一
筝	争ノㄋ
炬	火匚ㄋ一
葵	艹癸ㄋ
滕	月丨
铎	钅又一
恬	忄舌ノ一一
楷	木比ノ丨
袒	衤旦丨ㄋ
冕	日免ノㄋ
纶	纟人ノㄋ
疡	疒汤ㄋノ
埠	土一
偌	亻艹一ノ
蜈	虫口一一
橙	木登ㄋ丶
涧	氵门丨ㄋ一
蝙	虫户丨
瓒	王先ノ一丶
诲	讠每ノ一
殃	歹央丨ㄋ
痹	疒畀丨ㄋ丨
晖	日冖一ㄋ
蜷	虫ㄋ
鸳	夗鸟ノㄋ一
鹊	昔鸟ノㄋ一
蘑	艹麻一ノ
噶	口艹丨ㄋㄋ
碾	石尸一丨
珂	王可一丨
茧	艹虫丨
芮	艹内丨ㄋ
羔	灬丶丶丶
靳	革斤ノ
堰	土匚丨
黏	禾人丨丶
悻	忄土丶ノ
橄	木敢ノ一
曦	日ノ一
腋	月夜丶一丶
偕	亻比ノ丨
妩	女一一ノ
暧	日受一ノ
涟	氵车丶ㄋ
憧	忄立丨
拗	扌幺ㄋノ
胥	疋⺝丨ㄋ
芹	艹斤ノノ丨
俸	亻一一
圃	囗甫一丨
薰	艹千丨ㄋ丶
秧	禾央丨ㄋ丶丶
拌	扌半丶ノ丨
邯	甘阝ㄋ丨丨
锚	钅艹丨
悸	忄禾ㄋ丨
瑙	王巛ノ丨
砾	石丨ノ
癸	癸ㄋ丶
溥	氵甫一丨丶
磐	舟殳一ノ
凋	冫冂一丨
偎	亻田一
亟	了口ㄋ丶
嬴	赢女ㄋノ
橘	木矛丨ㄋ
滢	氵劳一一
懵	忄萝丶
绚	纟勹丨ㄋ一一
唆	口夋ㄋ丶
嚓	口宀ノㄋ丶丶
胺	月宀ㄋ
纂	目一ノ丶
撬	扌毛ノ一
肴	乂丨
蹊	爫ㄋㄋ丶
碉	石冂一丨
钠	钅内丨ㄋ
忐	上心丶ㄋ
楠	木十丨ㄋ
笺	戋一
渲	氵㝉丨ㄋ一
娼	女日丨
翡	非羽ㄋ丶
湄	氵丨ㄋ一
暨	旡丨
鳄	鱼吅一
萃	艹卒丶一
籽	米子ㄋ
枷	木加ㄋノ
骼	骨各ノㄋ一
韬	韦爫ノ丨
笙	生ノ一
潼	氵立丨ㄋ
祺	礻其一丨
岐	山十ㄋ丶
悴	忄卒丶一
攥	扌丨ㄋ丶
蜕	虫总ノㄋ
喋	口世一丨
聿	聿ㄋ一丨
氮	气炎丶ノ
踹	山一ノ
釜	父干丶
揩	扌比ノ丨一
叼	口一一
麓	林鹿丶一ㄋ
劾	亥力ㄋノ
嫔	女宀ノ丨
辎	车巛丨ㄋ
翌	羽立丶
绯	纟非丨
乓	丘丶丶丶
渤	氵孛ㄋ
俐	亻禾丨丨丨丨
粱	氵刀ノ丶丶
腓	月非丨一
撵	扌夫一一丨
赘	敖贝丨ㄋ丶
搐	扌玄丨ㄋ
茬	艹在一丨一
龋	齿禹ノ丨
遽	虍豕丶
饺	饣交丶
瘪	疒自ノ丶
怂	从心丶ㄋ丶丶
屹	山ㄋ
辕	车土丨ㄋ丶
沥	氵厂ㄋノ
缜	纟直ノ丶
讷	讠内丨
睾	丿罒一
蚤	又丶丨ㄋ
锭	钅定丶
榨	木穴ノ一
蛤	虫合ノ
瑾	王堇一丨一
攫	扌目丨ㄋ丶
捋	扌爫一丨丶
骥	马北丨
瓮	公瓦一ㄋ
汾	氵分ノ丶
惴	忄山一ノ
溉	氵一
惮	忄单丶
妊	女壬ノ
馀	饣余ノ丶
帧	巾⺊丨ㄋ
锌	钅辛丶
撂	扌田ノㄋ
酵	酉耂ㄋ丨一
哒	口大丶ㄋ
绛	纟夂ノㄋ
冗	冖几ノ
磺	石丨ㄋ丶
赈	贝辰一ノ
跤	交丶一
瀚	氵ノ丶
彗	丰丰ㄋ一一
簸	其ㄋノ
顼	王页一ノ丶
雳	雨厂ㄋ
愫	忄ㄋ
镰	钅广丶ノ
掂	扌广丨一
箍	扌一ㄋ
谚	讠产ノノ
卤	占乂ノ
跛	皮ㄋノ
筵	丿丨一
筵	丿丨
膺	广亻ノ丨一一
桢	木⺊丨ㄋ
皈	白ㄋ丶
渝	氵俞ノ丶
铢	钅丿一一
锵	钅丬ノㄋ
漾	氵丶ㄋ
瘩	疒艹ノ丶一
扈	户口ㄋ
啜	口双ㄋ丶丶
耆	耂旨ノㄋ
阪	阝ㄋ丶
萦	劳糸ㄋㄋ丶
囱	囟夂ノㄋ
暄	日㝉丨
藐	艹豸ノ丨
哝	口农丶ㄋノ
漳	氵音一丨
侏	亻丿一一丶
莞	艹宀一一
吮	口厶ノㄋ
栩	木羽ㄋ丶
砚	石见丨
匮	匚贵丨ㄋ丶
踞	尸一丨
潦	氵尞一ノ
涣	氵丨ㄋ
秤	禾平一丶
浚	氵夋ㄋ丶
濮	氵亻丨丨
瘸	疒加丨ㄋ丶
惬	忄匚一丶
琶	王王ㄋ丨
癖	疒辟ㄋ一
祗	礻氏丶丶
邺	业阝ㄋ
杞	木己ㄋ
螂	虫朗ㄋ
瞠	目一丨一一
烽	火夂一
蜒	虫丿丨一
讹	讠亻ノㄋ
臆	月音丶
蜿	虫宀ノㄋ
蹂	矛一丨丶
沂	氵斤ノノ
颍	匕水一ノ
帚	彐冖丨ㄋ丨
遐	叚辶丶
摒	扌尸丶
蟾	虫厃ノ丶一
娠	女辰一
螭	虫㐫丨ㄋ
蜗	虫呙丨
萼	艹吅一
淄	氵巛丨
馅	饣ノ丨
诠	讠人一一
苞	芍巳ㄋ一
谑	讠虍一ㄋ
氖	气乃ㄋノ
唧	口ㄋ丨
笆	巴ㄋ丨
蚩	蚩ㄋ丨
燎	火尞一ノ
谥	讠䒑ノ丶
掖	扌夜丶一
壑	⺊冖一ノ
蹋	日ㄋ丶一
寰	宀罒丨
黔	黑今ノ
骁	马尧一ㄋ
馋	饣免丶丶
豢	豕一
竣	立夋ㄋ
榄	木监丨ㄋㄋ
婵	女单丶ノ
玺	尔王丶丶
姗	女冂丨
饬	饣ㄋ
唰	口尸丨
鹉	一弋丨一
偃	亻匚丨
涎	氵丿丨一
呗	口贝丨ㄋ丶
麒	鹿其一丨丶
跷	尧一ㄋ
嗷	口敖一一丶
丕	不一一一
鼾	自畀一
阖	门去丨ㄋ一
撅	扌厂丶ノ
渍	氵丨ㄋ丶
臧	戊爿一
僭	亻旡一ㄋ一
炖	火屯一ㄋ
筱	亻丨ノ
噎	口壳一丨
缤	纟宀ノ丨
瑕	王叚ㄋ一
卯	卯卩ㄋ
烬	火尺丶丶丶
酪	酉各ノㄋ一
簌	束ノㄋ
漉	氵鹿丶一ㄋ
戌	戊一一
汶	氵文丶一
轲	车可一丨
汛	氵乙一丨丨
褶	衤羽ノ丨一
峦	亦山丨ㄋ丨
铐	钅耂一ㄋ
盅	中皿丨
踵	千丨ㄋ
苯	艹木一
胭	月因丨
晾	日京丶一
恙	心丶ㄋ丶
镯	钅罒ノㄋ丶
飒	立风ノㄋ
藕	艹耒丨ㄋ丶
筏	亻一ㄋ
萱	艹㝉丨ㄋ一
奂	央丨ㄋ
芥	艹人ノ丨丨
叁	叁三一一
憬	忄日丶一
媛	女爰ノ丶
碘	石曲ノ
彤	丹彡ノノノ
嗳	口受一
邙	亡阝ㄋ丨
酉	酉一丨一
兖	六厶ノㄋㄋ
茗	艹夕丨ㄋ一
沓	水日丨ㄋ一
嗟	口一丨一
闾	门口丨ㄋ一一
癞	疒束ノㄋ丶
挝	扌寸丶ㄋ
坯	土不一一一
鹫	京尢丶ノ
伫	亻㝉丶丶
锺	钅千丨ㄋ
雒	各隹ノ丨
荃	艹人一一
铿	钅坚一丨
挎	扌大一一ㄋ
飙	犬犬一ノ丶
蟋	虫丿丶ノ
谧	讠心ノ丨
亘	一旦丨ㄋ
猥	犭田一
惆	忄冂一丨一
蔷	艹十丶ノ
氟	气弓ノ丨
刽	人云丨丨丨
湍	氵山一ノ
媲	女囟ノ丶
璐	王ノㄋ
稷	禾田ノ
缄	纟咸一ノ
嗫	口耳ㄋ丶丶
垛	土几一丨
瘢	疒舟ノㄋ
蕙	艹惠丶ㄋ
浒	氵讠ノ一
甥	生田ㄋノ
迳	轻辶丶ㄋ丶
睑	目佥ノ丶一
甬	甬ㄋ丶
逵	土八一
祯	礻⺊丨ㄋ丶
鳖	敝鱼ノㄋ一
汞	工水丨
诰	讠告ノ一
恣	次心丶ㄋ
旌	族生ノ一
珑	王龙一ノ丶
梆	木ㄋ
螅	虫自丶ㄋ丶
斡	人丶丶
喏	口艹一
湮	氵覀一丨一
捺	扌大一一丶
胯	月大一一ㄋ
蘸	艹酉ノ丨丶
荔	艹力ㄋノ
螃	虫帝丶
蚌	虫丰一一
瀛	氵赢ㄋノ
踊	甬ㄋ
痔	疒土一丨
蟠	虫番ノ
皿	皿丨ㄋ一一
贰	弋二丨ㄋ
隼	隹十一丨
荼	艹余ノ丶
芷	艹止丨一
傩	亻又ノ丨
蓟	艹鱼丨丨
徵	微壬ノ一
泯	氵民ㄋ一
簪	旡一ㄋ一
骰	骨殳ノㄋ
脐	月文ノ丨
飓	风ノ
孺	孑雨一ノ丨
辘	车鹿丶
佚	亻丿一一丶丶
羚	羊令ノ丶
漕	氵曹一丨
皋	白大一丨
晁	日儿丶一丶
桦	木华ノㄋㄋ
髅	骨米ㄋ
楔	木丰ㄋノ
抠	扌区一ノㄋ
谄	讠ノ丨
赡	贝厃ノ丶
唷	口丨ㄋ
寐	宀爿一一
蜻	虫青一
疣	疒尢丶
椰	木耳ㄋ丨
嘭	口壴ノノ
篓	米ㄋノ一
蟀	虫玄丶一
崆	山穴一丨
蹒	艹一丨
泵	石水丨
搪	扌广ㄋ一
玷	王占丨一
噼	口辟ㄋ一丨
卞	丶下一
镀	钅度ㄋ
鑫	金金ノ丶
琏	王车丶ㄋ
犊	牜十ㄋ丶
娓	女尸ノ一
杳	木日丨
昙	日云一一
闰	门王一一一一
篆	彖ㄋㄋ
踝	日一丨
呷	口甲丨ㄋ
缨	纟贝丨ㄋ
熹	壴口丶
蓓	荷立丨
璞	王业丶ノ
坂	土ㄋ丶丶
鹞	爫缶ノㄋ
钾	钅甲丨
剁	几木丨
瞑	目冖丨ㄋ
谩	讠日丨ㄋ丶
佼	亻交丶
戾	户犬一ノ
噤	口林一一丶
汕	氵山丨ㄋ
馍	饣莫一丨
赓	广彐ノ丶丶
煜	火日丶
嗥	口白一ノ
谙	讠音丶
塾	享九丶一
茉	艹未一一
髻	髟吉一丨
秸	禾吉一丨
贲	十艹丨ㄋ丶
湃	氵一一
泗	氵四丨ㄋ一
袂	衤夬ㄋ一
迢	召辶丶ㄋ丶丶
淞	氵木ノ丶丶
煦	日句丶
潞	氵ノㄋ
耷	大耳一丨
婊	女ノ
掰	分ノ一
涸	氵囗一丨一一
拄	扌主丶一
鳃	鱼田丶ㄋ
盂	于皿丨ㄋ
傣	亻丨
虱	丿丨ㄋ丶
羲	禾一ㄋ
喙	口彖ㄋㄋ
麝	鹿身一丨
撸	扌鱼丨ㄋ一
欤	与一ノㄋ丶
徇	彳勹丨ㄋ
躏	艹丶
痞	疒不丨ㄋ
匝	匚巾丨ㄋ
咂	口匚丨ㄋ丨
豺	豸才一丨
锷	钅吅一
纣	纟寸一丨
夙	几歹一ノ
诙	讠丶ノ丶
喟	口田丨ㄋ
瞌	目去丨ㄋ
窿	穴阝ノㄋ
荪	艹孑丨ノ
潺	氵尸ㄋ丨
啬	十䒑丨ㄋ一
坷	土可一
匍	勹甫一丨丶
殡	歹宀ノ丨
岌	山及ノ
缮	纟羊丶ノ
澹	氵厃ノ丶一
蛰	执虫丨ㄋ丶
锏	钅门丨ㄋ一
斛	角⺀一丨
嗬	口荷一丨丨
恫	忄冂一丨
蟆	虫莫一丨丶
町	田丁一丨
骠	马覀一一
唏	口希ノ丶
橹	木鱼丨ㄋ
钡	气贝丨ㄋ丶
卅	一川ノ
螳	虫一丨
胱	月光丨
皑	白山ㄋ
淇	氵其一丨丶
谀	讠臼ノ丶丶
鸯	央鸟ノㄋ
跻	文ノ丨丨
擞	扌米ㄋノ丶
椿	木丨
篝	冓一
嘤	口贝丨ㄋ一
厩	厂一ㄋ
腆	月曲ノ丶
蛀	虫主丶一
嵇	禾尢丶丨
邬	乌阝一
恚	圭心丶ㄋ丶丶
辍	车双ㄋ丶
箓	录ㄋ一
咻	口亻一丨
涓	氵口丨ㄋ一
夔	䒑自丨一
轶	车丿一一丶
邃	穴㒸丶
跚	冂丨ㄋ
翱	白大一丨一
嚏	口孛丨
曜	日羽ノ丨
珥	王耳一
岱	代山丨ㄋ
瞰	目敢ノ一
葆	荷口一丨丶
臼	臼ノ丨一
籁	束ノㄋ丶
眈	目冖ノㄋ
谆	讠享丶一
苻	荷寸一
猓	犭日一丨丶
扉	户非丨
槌	木丶ㄋ
箕	其ノ丶
蔗	艹度丶丶
啾	口禾丶ノ
荤	劳车一ㄋ
腼	月丆丨ㄋ
泾	氵轻ㄋ丶一
剽	覀示丨丨
龛	合龙一ノ丶
锢	钅囗一丨
骧	马襄丶一
淖	氵卓丨一
酮	酉冂一丨
雹	雨勹ㄋ
恿	甬心丶ㄋ
獗	犭厂丶ノ
裆	衤ㄋ
鹳	艹吅ノ丨
牒	片世一
痣	疒士丶
焙	火立丨
樟	木音一丨
檬	木劳一一丶
疵	疒此丨一
熠	火羽ノ丨
睽	目癸ㄋ丶
蚯	虫丘ノ丨
泞	氵宀一丨丨丨
蛹	虫甬ㄋ
畹	田宀ノㄋ
淬	氵卒丶
飕	风臼
怆	忄仓ノ丶
罹	罒忄ノ
浣	氵宀一一
桧	木人一一丶丶
鋆	土勹丶一
宸	宀辰一ノ
琥	王虍ノㄋㄋ
銮	亦金ノ丶
啐	口卒丶一
睐	目夹丨
沣	氵丰一一丨
翦	前羽ㄋ丶
颚	吅亏一ノ丶
镐	钅高丶一一一
沅	氵元一一
祛	礻去一丨丶
璜	王丨ㄋ
斓	文门一丨丶丶
庖	广勹ㄋ一
娲	女呙丨ㄋ
荟	艹人一一丶
咫	尺口丨ㄋ丶丶
皎	白交丶
僮	亻立丨ㄋ一
昵	日尸ノㄋ
氦	气亥丶一
罔	冂䒑丶一
闩	门一一一一
溟	氵冖丶一
槟	木宀ノ丨
缥	纟覀一一丶
蛔	虫回丨
楣	木丨
靥	厂犬一ノ一
黜	黑出ㄋ丨
囔	口橐丨ㄋ丶
骋	马由一ㄋ
阂	门亥丶
榈	木门丨ㄋ
忻	忄斤ノノ
橇	木毛ノ一
妍	女开一一
瘠	疒ノ丶
灸	久火丶ノ丶丶
镁	钅一ノ丶
杵	木一丨丨
儡	亻田丨ㄋ
噫	口音丶ㄋ
腌	月大丨ㄋ
耘	耒云一一
觐	堇见丨ㄋㄋ
焊	火日一一
醮	酉隹丶丶丶
黠	黑吉一丨一
醺	酉千丨ㄋ丶
侗	亻冂一丨一一
椋	木京丶一
舀	爫臼ノ
裨	衤卑ノ
窠	穴日一丨
癣	疒鱼丶
瘴	疒音一丨
芍	芍丶丶丶
耙	耒巴ㄋ丨
榕	木宀ノ丶
捱	扌厂一丨
摞	扌田ㄋㄋ丶
痘	疒豆一丨
睢	目隹ノ丨一
栾	亦木一丨丶
龈	齿艮ㄋ一
鬃	髟宀一一
绾	纟宀丨ㄋ一
擢	扌羽ノ丨
獠	犭尞一ノ
蛆	虫且丨
弈	亦廾一ノ丨
铛	钅ㄋ一
谗	讠免丶丶
倌	亻宀丨
邝	广阝ㄋ丨
痫	疒门一丨
邕	巛口ㄋ丨
啷	口朗ㄋ丨丨
圪	土ㄋ
酰	酉先ノ一
晔	日华ノㄋ
佗	亻宀ノㄋ
渥	氵尸一ㄋ
睨	目臼ノㄋ
蜥	虫木ノノ
郸	单阝ㄋ丨丨
镌	钅隹ㄋ
孛	孛子ㄋ丨一
鳗	鱼日丨ㄋ丶
痢	疒禾丨丨丨
秆	禾干一一
嚅	口雨一ノ丨
胄	由⺝丨ㄋ一
郅	至阝ㄋ丨
蝌	虫禾丶丶
瘀	疒方ノ
觊	山己丨ㄋ
蚪	虫⺀一丨丨
暹	日隹丶ㄋ
穑	禾十丶ノ
锹	钅禾丶
糯	米雨一ノ
蛐	虫曲丨ㄋ
哂	口西一丨一
蜓	虫壬ㄋ丶
掸	扌单丶ノ
疟	疒一ㄋ
喵	口艹丨ㄋ一一
岖	山区一ノ
摺	扌羽ノ丨一
蹩	敝足丨ㄋ丶
莓	艹每ノ一
谌	讠其ㄋㄋ
岬	山甲丨ㄋ
囤	囗屯一ㄋㄋ
糠	米广ㄋ一丶
嬷	女麻ノㄋ
汩	氵囗一一一
酗	酉乂ㄋ丨丨
蚣	虫公ノ
洵	氵勹丨ㄋ一一
蜃	辰虫丨ㄋ
舐	舌氏ノㄋ
弑	乂朩一ㄋ
鳎	鱼日ㄋ丶一一
棣	木隶ㄋ一
峪	山谷ノ丶
孪	亦子ㄋ
疱	疒勹ㄋ
炀	火汤ㄋ
箩	罒ノㄋ
阚	门敢ノ一
龇	齿此丨一
镂	钅米ㄋ
徨	彳白一一
郢	口王ㄋ丨
袤	亠矛ノㄋ丶
蚓	虫弓丨
咣	口光丨丶
盹	目屯一ㄋ
砥	石氏丶丶
荚	艹夹ノ丶丶
偈	亻曷丨ㄋ
氐	氏丶丶丶丶
鄱	番阝ㄋ丨丨丨
愠	忄日丨
咛	口宀一丨丨
怏	忄央丨
琊	王牙ㄋ
苓	艹令ノ
淙	氵宀一一丶
馁	饣爫ㄋノ一一
鹄	告鸟ノㄋ一
柠	木宀一丨丨
涝	氵劳ㄋノノ
濑	氵束ノㄋ丶
芋	艹于一一丨
胫	月轻ㄋ丶
璀	王山ノ丨一
隽	隹乃ㄋ
燮	言火丶ノ丶丶
弋	弋一ㄋ丶
窈	穴幺ㄋノ
鹭	各ノㄋ一
泓	氵弓ㄋ丶
畿	幺幺一ㄋ一
衢	彳目丨ㄋ
碴	石木丨ㄋ一
韭	非一一一一
瑁	王日丨ㄋ一一
筠	土ノㄋ
涿	氵豕丶丶
戛	丆目一
龌	齿尸一ㄋ
婀	女阝一丨
宓	宀必丶ㄋ丶
臊	月口丨ㄋ
豌	豆宀ノㄋ
宕	宀石一ノ
蟑	虫音一
骊	马丽一丨丶
鲫	鱼ㄋ丨
鲇	鱼占丨一
煊	火㝉丨ㄋ
罂	贝贝ノ一
铬	钅各ノㄋ一
娩	女免ノㄋ
蒯	艹月ノ
骈	马䒑一ノ
褴	衤监丨ㄋ
洄	氵回丨ㄋ
谔	讠吅一一
镣	钅尞一ノ
箴	咸一
檄	木白丶
妲	女旦丨
崂	山劳ㄋノ
沏	氵七ㄋノノ
蒿	艹高丶一
鹗	吅亏ノ
疽	疒且丨ㄋ
纫	纟刀丶丶
啵	口氵ㄋノ
汐	氵夕ノㄋ丶丶
魇	厂犬ノ丨
殒	歹口丨ㄋ丶
俦	亻一丨丶
榭	木身一丨丶
蓿	艹宀ノ丨
幺	幺ㄋㄋ
绺	纟夂丨丶
迩	尔辶丶ㄋ丶丶
粼	米舛ㄋㄋ
圩	土于一一丨
琬	王宀ノㄋㄋ
诋	讠氏丶丶
靼	革旦丨ㄋ
忑	下心丶ㄋ
藓	艹鱼丶ノ
俚	亻里丨ㄋ一
饕	口丂丨一
殁	歹殳ノㄋ
仄	厂人ノ丶
蠡	彖虫丨ㄋ丶
牍	片十ㄋ丶丶
诳	讠犭一一
懋	木矛一丨
霭	雨讠丨ㄋ
熵	火商丶一
掬	扌勹丶ノ丶
锰	钅子丨ㄋ一
濂	氵广丶ノ
袈	加衣丶一
婕	女妻丨一
镭	钅雨丨ㄋ
皙	木斤ノ丨一
咝	口ㄋㄋ一
斫	石斤ノノ
褛	衤米ㄋノ一
臃	月亠ㄋ
娑	氵小ノㄋ
榷	木冖ノ丨
埂	土更一丨
匐	勹同丨ㄋ
噙	口人丶一
柑	木甘一丨一
犒	牜高丶一
歆	音欠ノㄋ
蓑	艹哀一ノ
馐	饣ㄋ丨
孢	孑勹ㄋ一
郦	丽阝ㄋ丨
霾	雨豸丨ㄋ一一
鸵	鸟宀ノㄋㄋ
叵	匚口丨ㄋ
氲	气日丨ㄋ
鲲	鱼日一ㄋ
祚	礻乍ノ一
鹑	享鸟ノㄋ
啮	口齿丨一
滦	氵亦一丨丶
岷	山民ㄋ一
艮	艮ㄋ一
纭	纟云一一
恸	忄云ㄋノ
娉	女由一
滂	氵帝丶一ノ
扪	扌门丶丨
讫	讠ㄋㄋ
诿	讠禾ㄋノ一
弁	厶廾一ノ
蛭	虫至一ㄋ
谡	讠田ノ丶
莘	艹辛丶一
砧	石占丨一
啻	帝巾丨ㄋ一
舫	舟方丶一
荨	艹彐一丨
雉	矢隹ノ
俑	亻甬ㄋ丶
辇	夫夫一ㄋ
椽	木彖ㄋㄋ
冽	冫歹丨丨
泸	氵⺊ㄋ一
钛	钅大丶丶
榔	木朗ㄋ
蕨	艹厂丶ノ丶
诒	讠台ㄋ丶
覃	覀早丨ㄋ丨
揆	扌癸ㄋ丶
蟮	虫羊丶ノ
翊	立羽ㄋ丶
烯	火希ノ丶
獾	犭艹丨ㄋ一一
缙	纟亚丨ㄋ一一
摈	扌宀ノ丨
姣	女交丶
憩	舌自丶ㄋ丶
鲈	鱼⺊ㄋ一
嘹	口尞一ノ
钚	钅不一ノ丶丶
孀	女雨一丨
纾	纟予ㄋ丶
洌	氵歹丨丨
饨	饣屯一ㄋ
瘁	疒卒丶
剐	呙刂丨丨
浜	氵丘ノ丶
祐	礻丨ㄋ一
缇	纟是丨
粲	⺊夕ㄋ丶丶
烷	火宀一一
嶙	山米ノㄋ
怵	忄木丶丶
隍	阝白一一
篙	高丶
沱	氵宀ノㄋ
猕	犭弓ノㄋ
挞	扌大丶ㄋ
蹶	厂丶ノ
赊	贝人一一丶丶
摁	扌因丶
铡	钅贝丨丨
涮	氵尸丨ㄋ丨
噘	口厂丶ノ
刍	刍ノㄋ
鲑	鱼圭一丨
狻	犭夋ㄋ丶
遛	留田丶
耄	耂匕ノ一
垠	土艮ㄋ一丶
蝮	虫复ノ一
樽	木酋一丨
妫	女为丶ノ
坳	土幺ㄋ
茁	艹出ㄋ丨
呓	口艹ㄋㄋ
箔	氵ノ丨
莒	艹口丨
钜	钅匚ㄋ一
懔	忄亠丨ㄋ
蚱	虫乍ノ
夥	日木ノㄋ丶
濡	氵雨一ノ
阡	阝千ノ
谘	讠次丨ㄋ
犄	牜大一丨
慵	忄广ㄋ一
颧	艹吅ノ丨丶
佞	亻二ㄋノ
纨	纟九丶丶
铤	钅壬ㄋ丶
熨	尸示一丨丶
剜	宀夗丨丨
殓	歹佥ノ
骛	矛攵ㄋㄋ
辏	车ノ一
庑	广一一ノ
邂	角刀ノ一
唑	口从一丨
槁	木高丶
瞭	目尞一ノ丶
祉	礻止丨一
诤	讠争ノ
猬	犭田丨ㄋ
犟	弓口丨ㄋ丨
夯	大力ㄋノノ
钰	钅王丶丶
妪	女区一ノ
胪	月⺊ㄋ一ノ
恁	亻壬丶ㄋ丶
馕	饣橐丨
荩	艹尺丶丶
罄	士ノㄋ丨
榘	大一ㄋ
闱	门韦一一
靓	青见丨ㄋ
谝	讠户丨
僖	亻壴丨ㄋ
仨	亻三一一
簦	登ㄋ丶
榛	木ノ一
饯	饣戋一
宥	宀丨ㄋ一
潢	氵丨
寮	宀尞一ノ
涔	氵山ノ丶ㄋ
忤	忄一丨丨
泅	氵囗ノ丶
胴	月冂一丨一
隗	阝鬼ノ
蝈	虫囗一一丶
墉	土广ㄋ一一
砷	石日丨丨
珞	王各ノㄋ一
觥	角光丨丶
荥	劳水丨ㄋ
鳅	鱼禾丶
菠	落皮ㄋノ
獭	犭束ノㄋ
鏖	鹿金ノ
柚	木由丨ㄋ
倜	亻冂一丨一
嘁	口戊丨一
淅	氵木ノノ
掇	扌双ㄋ丶丶
蛳	虫一
氤	气因丨ㄋ
涞	氵夹丨ノ
酚	酉分ノ丶ノ
繇	爫缶ノㄋ丶
烨	火华ノㄋㄋ
燔	火番ノ
峒	山冂一丨
邋	巛囗ノ
俅	亻求一丨
咿	口亻ㄋ一
嗑	口去丨ㄋ一
镍	钅自一丨丶
旖	族大一丨丨
蚜	虫牙一ㄋ
霁	雨文ノ丨
椤	木罒ノㄋ丶
鼐	乃目ㄋ一
辔	纟车ㄋㄋ
咤	口宀ノ一
踮	广丨一
峋	山勹丨ㄋ一
拮	扌吉一丨一
酯	酉旨ノㄋ一
饽	饣孛ㄋ丨
壹	壳豆一丨一
癜	疒尸一丨
庋	广十ㄋ
迨	台辶丶ㄋ
搽	扌艹ノ丶丶
蛎	虫厂一ㄋ
谶	讠从一ㄋ
龊	齿足丨ㄋ
赳	走丩ㄋ
偻	亻米ㄋノ
邛	工阝ㄋ丨
槊	屰月一丨
媾	女冓一一一
铣	钅先ノ
啕	口勹ノ
嗵	口甬丶ㄋ丶
馄	饣日一ㄋ
飚	风火丶ノ丶
嗝	口鬲一丨丨
恽	忄冖一ㄋ
墒	土啇丶一
琰	王炎丶ノ
榀	木口丨ㄋ一
醯	酉㐬丨ㄋ一
哐	口匚一一一
儆	亻艹ノㄋ丶
魑	鬼㐫丨ㄋ
笞	台ㄋ丶
遑	白王丶ㄋ
嗲	口父ノㄋ丶
枞	木从ノ丶丶
苌	艹长ノ一
氰	气青一一
橐	橐石一丨
妤	女予ㄋ丶
馊	饣臼丨
莅	荷立丶一一
燧	火㒸丶ㄋ
缈	纟目丨ノ
邈	豸白ノㄋ
伲	亻尸ノㄋ
闼	门大丶ㄋ
懑	氵艹一丨丶
庠	广羊丶ノ
杈	木又丶丶
抟	扌专一一
逅	同丶
荻	艹犭丶ノ
馥	禾日ノ
噔	口登ㄋ丶
馑	饣堇一
矾	石凡ノㄋ丶丶
蔫	艹正一ㄋ
劭	召力ㄋノ
昕	日斤ノノ
呶	口女ㄋ丶
栎	木丨ノ
昱	日立丶
迤	也丶ㄋ
庾	广臼ノ丶
汜	氵巳ㄋ
殇	歹ㄋ
柩	木匚ノㄋ丶
忝	天丨丶
鳝	鱼羊丶ノ一
囿	囗丨ㄋ
颦	止一ノ丨
衮	六厶ノㄋ丶
苷	艹甘一丨一
镳	钅鹿丶丶
蠹	橐石丨ㄋ丶
飧	夕食ノ
腴	月臼ノ丶丶
忸	忄丑ㄋ
谯	讠隹丶丶
琨	王日一ㄋㄋ
觎	俞见丨
鞯	革艹一
飨	乡食ノ丶
笏	勿ノㄋノ
郏	夹人ㄋ
凇	冫木ノ丶
饪	饣壬ノ一一
淼	水水丨ㄋ丶
爻	爻ノ丶
蜚	非虫丨
鋈	氵夭ノ丶
诜	讠先ノ一ㄋ
鸢	弋鸟ノ
蔺	艹门ノ丨
觯	角单丶ノ
铳	钅ノㄋ
麋	鹿米丶ノ
呲	口此丨一
湎	氵丆丨ㄋ
竦	立束一丨
奘	爿士一
肽	月大丶丶
芪	艹氏ノㄋ
缫	纟巛丨
膘	月覀一
荭	艹纟一丨
苫	艹占丨一
臾	臼人ノ
粑	米巴ㄋ丨
阗	门直ノ丶丶
俪	亻丽一丨丶
滓	氵宀丶一丨
蜇	折虫丨ㄋ
趔	走歹丨
呦	口幺ㄋノ
嘣	口山ノㄋ一
菟	艹免丶丶
藜	艹禾ノㄋ
栉	木艹ㄋ丨
佘	人示一一丶
濠	氵亮一ノ
稹	禾直ノ丶
疸	疒旦丨ㄋ一
虻	虫亡丶一
佝	亻句ノㄋ
枸	木句ノㄋ一
孱	尸子ㄋ
铩	钅乂一
膑	月宀ノ丨
霏	雨非丨一
龢	合吅丨
赝	厂亻ノ丨丶
蝼	虫米ㄋノ
濯	氵羽ノ丨
乩	占乚ㄋㄋ
祜	礻古一丨一
霰	雨丨ㄋ丶
盥	𦥑水丨ㄋ
锨	钅斤ノㄋ丶
谖	讠爰ノ丶
蛉	虫令ノ丶
肓	亡⺝丨ㄋ一
趺	夫一一
徭	彳爫ノ
倨	亻尸一丨一
硼	石月ノㄋ
鱿	鱼尢丶丶
绉	纟刍ノ
锲	钅丰ㄋノノ
詈	罒言丶
埽	土彐丶ㄋ
诨	讠冖一ㄋ
虢	爫寸丨一
楹	木乃ㄋ丶
娣	女弟丶
洹	氵一丨ㄋ一
绻	纟ㄋㄋ
铰	钅交丶一
锃	钅口一一一
晟	日戊ㄋㄋ
泱	氵央丨ㄋ丶
芩	艹今ノ丶
桎	木至一ㄋ
浔	氵彐一丨丶
淦	氵金ノ丶
酆	山丰一一丨
巽	巳巳一
羿	羽廾一ノ
呤	口令ノ丶
澧	氵曲一丨一
戡	其乚一ㄋ丶
蜴	虫日ノ
渚	氵者一丨一
犷	犭广丶一
魃	鬼ㄋ
郧	口贝ㄋ丨
诮	讠肖丨丶
崴	山戊一ㄋ一
砺	石厂一ㄋ
纥	纟ㄋㄋ
颀	斤页一ノ
讣	讠卜丨丶
谪	讠商丶一
绦	纟夂一丨丶
馗	九䒑ノ
垩	亚土一丨
岫	山由丨ㄋ一
搡	扌又ㄋ丶丶丶
璨	王⺊ノㄋ
遨	敖辶丶ㄋ丶
铂	钅白ノ丨
眦	目此丨
髭	髟此丨一
轱	车十丨ㄋ一
铨	钅人一一
泷	氵龙一ノ丶
纰	纟比一ㄋㄋ
锟	钅日一ㄋ
卟	口卜丨丶
蹴	京一ノ
姘	女䒑一
粽	米宀一一丶
榉	木兴ノ丶丨
赭	赤者一丨
罅	缶虍ノ丶
诟	讠一丨
龅	齿勹ㄋ一
陂	阝皮ㄋノ
瘙	疒又丶丨
伉	亻亠ノㄋㄋ
姹	女宀ノ一
鸬	⺊尸ノㄋ
撷	扌吉一ノ
笥	一
螨	虫艹一丨
翳	匚矢ノㄋ
秣	禾未一一
晗	日今丨ㄋ一
诓	讠匚一一
翕	合羽ㄋ丶
鹌	大日ㄋノ
碣	石曷丨ㄋ
箸	者一丨
痿	疒禾ㄋ
跸	比一丨丨
咭	口吉一丨
赧	赤卩ㄋ丶
舛	舛ノㄋ
襁	衤弓丨ㄋ
蹇	寒足丨ㄋ
砭	石丿丶ㄋ丶
诌	讠刍ノㄋ
薨	萝冖一
涪	氵立丨ㄋ一
汨	氵日丨ㄋ一一
怼	又寸丶ㄋ
羯	曷丨ㄋㄋ
揄	扌俞ノ丶
茯	荷犬一ノ
钍	钅土一丨
粕	米白ノ丨
愎	忄复ノ一
窕	穴儿丶
醴	酉曲一
鍪	矛攵ノ丶一
鹘	骨鸟ノ
煨	火田一
锉	钅从一丨一
誊	言丶
髡	髟兀一ノ
聒	耳舌ノ一
梏	木告ノ一
陲	阝垂ノ一
闳	门ㄋ丶
阕	门癸ㄋ丶
戕	爿戈一ㄋ
竑	立ㄋ
郓	冖车ㄋ
湟	氵白一一一
畦	田圭一丨一
鄢	正与丶丶
钨	钅乌ㄋ
碜	石叁ノノ
鲟	鱼彐一丨丶
肱	月ㄋ丶
艿	艹乃ㄋノ
咩	口羊丶ノ
衩	衤又丶
艄	舟肖丨丶
鸨	匕十ノㄋ一
噌	口曾丶ノ一
吒	口乇ノ一ㄋ
峥	山争ノㄋ
逡	夋辶丶ㄋ丶
珏	王王丶丶
褡	衤艹ノ丶
刈	乂刂丨丨
麂	鹿几ノㄋㄋㄋ
阈	门戈丨ㄋ
酢	酉乍ノ一一
臬	自木一丨
媪	女日丨ㄋ
玮	王韦一一丨
夤	夕㝉丨ㄋ丶
孳	䒑幺ㄋㄋ一
钹	钅ㄋ丶
馏	饣留丨ㄋ
鸷	扌执ノㄋ
幄	巾尸一ㄋ一
矍	目目ノ丨丶
潍	氵纟ノ丨
讴	讠区一ノㄋ
裱	衤ノㄋ丶
哙	口人一一
砒	石比一ㄋㄋ
胛	月甲丨
呔	口大丶丶
苁	艹从ノ丶
薏	艹音丶
芊	艹千ノ一丨
驷	马四丨ㄋ
谲	讠矛丨ㄋ
喑	口音丶一
闿	门山ㄋ一
俎	从且丨ㄋ一
砦	此石一ノ一
猷	酋犬一ノ丶
骞	寒马ㄋㄋ
痨	疒劳ㄋノ
芨	艹及ノㄋ丶
阏	门方ノ丶
弭	弓耳一丨
璎	王贝丨ㄋ一
爰	爰ノ丶丶
歙	合羽ノㄋ
氅	尚攵ノ一
篾	罒一ノ
煲	华口丶ノ
铉	钅玄丶一
厝	厂昔一丨
楫	木口一丨
牝	牜匕ノㄋ
徕	彳夹丨
稗	禾卑ノ
衾	今衣丶
钴	钅古一丨一
豕	豕一ノ
烩	火人一一丶
骅	马华ノㄋㄋㄋ
樾	木走一ㄋ
桠	木亚一丨
峁	山卯ㄋ丨
赍	十从丶ㄋ丶
怩	忄尸ノㄋ
掴	扌囗一一丶
囫	囗勿ノㄋノ
啖	口炎丶ノ
碛	石丨ㄋ丶
圻	土斤ノノ
裟	氵小ノ丶
馔	饣巳ㄋ一
揿	扌钅ノㄋ
趄	走且丨ㄋ一
茏	艹龙一ノ
楂	木木丨ㄋ
嵘	山劳一丨丶
囡	囗女ㄋノ
鹬	矛冏ノㄋ
逖	犭火丶ㄋ
甑	曾瓦一ㄋ
錾	车斤ノ丶
殚	歹单丶ノ
逋	甫辶丶ㄋ丶
嗪	口ノ一
潸	氵林丨ㄋ
痤	疒从一丨一
孬	不女ㄋ丨
蕲	艹单ノノ
炜	火韦一一
佥	佥ノ丶一
苣	艹匚ㄋ
傥	亻ノㄋㄋㄋ
阄	门丨ㄋㄋ
瓯	区瓦一ㄋ
嵬	山鬼ノ丨
胝	月氏丶丶
莆	艹甫一
昶	永日丨ㄋ一
杲	日木一丨丶
嶂	山音一丨
砣	石宀ノㄋ
酊	酉丁一丨丨丨
绌	纟出ㄋ丨丨
揶	扌耳ㄋ丨丨
鬣	髟巛丨ㄋ
唁	口言丶
渌	氵录ㄋ一
抻	扌日丨丨
螓	虫ノ一
蠼	虫目丨ㄋ
黍	禾人丨丶丶
帼	巾囗一一丶
铱	钅衣丶
媸	女蚩ㄋ
魍	鬼冂丶ノ
湫	氵禾丶ノ
颏	亥页一ノ
鼹	鼠日丶丶
遴	米舛丶ㄋ
踅	折足丨ㄋ
薮	艹米ㄋノ
镏	钅留丨ㄋ
鸩	冖儿ノㄋ
鎏	氵㐬丶一ㄋ
勖	日目ㄋノ
洱	氵耳一丨
舢	舟山丨ㄋ丨
蚝	虫毛ノ
猗	犭大一丨丨
骓	马隹ノ丨
闶	门亠ノㄋㄋ
嬗	女亠丨
沤	氵区一ノ
鄯	羊䒑丨ㄋ
竽	于一一丨
苋	艹见丨ㄋㄋ
獐	犭音一丨
啶	口定丶丶
颢	日京一ノ
砝	石去一丨
恂	忄勹丨ㄋ
悌	忄弟丶ノ
羸	赢羊丶ノ
醛	酉艹ノ丶一一
鲛	鱼交丶一丶
缢	纟䒑ノ
棂	木彐丶
掼	扌毌丨ㄋ
耨	耒辰一丨丶
螫	赤攵丨ㄋ丶
珈	王加ㄋノ一
琮	王宀一一丶
痂	疒加ㄋノ一
耦	耒禺丨
硎	石开丨丨
掾	扌彖ㄋㄋ
酩	酉夕丨ㄋ
骶	骨氏丶丶丶
觞	角ㄋノ
淝	氵月ㄋ丨
钺	钅戉一ㄋ丶
峤	山夭ノ丨
硒	石西一丨一
舸	舟可一丨丨
旃	族丹ノㄋ
脍	月人一一丶
疥	疒人ノ丨
轭	车厂ㄋ
螟	虫冖丨ㄋ
蚨	虫夫一一
橛	木厂丶ノ
蜊	虫禾丨
炔	火夬ㄋ一
嗄	口丆丨ㄋ丶
痈	疒用ノㄋ
榫	木隹一丨丨丨
笤	召ㄋノ
笕	见丨ㄋㄋ
讵	讠匚ㄋ一
猊	犭臼ノㄋ
钤	钅今ノ丶
噱	口虍一ノ
阆	门良丶ㄋ
槿	木堇一丨一
壅	亠乡ノ丨一
荞	艹夭ノ丨
礴	石落一
毂	壳车ノㄋ
俣	亻口一一丶
阋	门臼ノ
矸	石干一一
绡	纟肖丨丶
锂	钅里丨ㄋ
掮	扌户丨
龃	齿且丨ㄋ一
菏	落可一丨
苡	艹以ㄋ
轸	车㐱ノ丶
穰	禾襄丶
磬	士ノㄋ一
涫	氵宀丨ㄋ一一
蓖	艹囟ノ丶ㄋ
焓	火今丨ㄋ一
鲧	鱼丿ㄋㄋ丶
浃	氵夹ノ丶丶
瓤	襄瓜ノ
齑	文丨一
苜	艹目丨
玖	王久ノㄋ丶
謇	寒言丶
蒺	艹疒ノ一丶
钏	钅川ノ丨
杼	木予ㄋ丶
鹜	矛攵ノㄋ
舂	臼ノ丨一
烃	火轻ㄋ丶
鲂	鱼方丶一ノ
莜	荷丨ノ一
缗	纟民丨ㄋ一
玳	王亻一ㄋ丶
笫	弟ノㄋ
恹	忄厂一
葭	艹叚ㄋ一
仃	亻丁一丨
逶	禾女丶ㄋ丶
氩	气亚一
龉	齿五丨ㄋ
圜	囗罒丨
愆	彳氵一一丶
蟪	虫惠丶
俳	亻非丨一
锴	钅比ノ
啭	口车一一
畲	人示丨ㄋ
窣	穴卒丶一
匦	匚车ノㄋㄋ
笮	乍ノ一
葺	艹口一丨一一
稔	禾今丶ㄋ
姝	女丿一一丶
屐	尸彳一丨丶
瑭	王广ㄋ一
菀	艹宀ノㄋ
挈	丰刀ノ一丨
郯	炎卩ㄋ
崧	山木ノ丶丶
岢	山可一丨丨
赜	丨
腱	月聿ㄋ
焱	火火丶ノ
槭	木戊丨一
潆	氵劳ㄋㄋ
箐	青一一
魉	鬼丙ノ丶
烊	火羊丶ノ丨
姒	女以ㄋ丶
靛	青定丶丶
牦	牜毛ノ一
褓	衤华丨ㄋ一
蛴	虫文ノ丨
牯	牛古一丨
帑	奴巾丨
泠	氵令ノ丶
诖	讠圭一丨一
衽	衤壬ノ一一
茑	艹鸟ノㄋ一一
殛	歹了丨ㄋ一一
毖	比必丶ㄋ丶丶
芾	艹一丨ㄋ丨
诹	讠耳ㄋ丶丶
谠	讠ノㄋ
诂	讠古一丨一
蛩	工凡丨ㄋ
炷	火主丶一
颛	山雨一ノ
忾	忄气ノ一
刎	勿刂丨丨
柞	木乍ノ一
碇	石定丶丶
戬	亚日丨ㄋ丶
郛	爫孑ㄋ丨丨
蚴	虫幺ㄋ
曷	曷丨ㄋ
樯	木十丶ノ
饧	饣汤ㄋ
窸	穴丿丶ノ
镉	钅鬲一丨丨
唳	口户一ノ丶
妗	女今ノ丶ㄋ
溴	氵自一ノ丶丶
菖	艹日丨ㄋ
蛞	虫舌ノ
鹧	度灬ノㄋ
缂	纟革一
蠖	虫艹ノ
鸪	古鸟ノㄋ
吡	口比一ㄋ
枰	木平一丶
灏	氵日丶一
岘	山见丨ㄋㄋㄋ
崮	山囗一丨
饔	亠乡ノ丨丶丶
婺	矛攵ㄋノ
邳	不一ㄋ
鬈	髟ㄋㄋ
蛄	虫古一丨一
阒	门目一ノ
磔	石舛一丨丶
蘅	艹彳ノㄋ丨
睥	目卑ノ丨
氚	气川ノ丨
旎	族尸ノㄋㄋ
凫	几ノㄋㄋ
鞣	革矛一丨
缟	纟高丶一
缦	纟日丨ㄋ
旮	九日丨ㄋ
犍	牜聿ㄋ丶
蠲	䒑八丨
焖	火门丶ㄋ
遢	日羽丶
灞	氵雨一丨一
鲆	鱼平一丶
趿	及ノㄋ
踽	禹ノ丨
颞	耳双一ノ
缁	纟巛丨ㄋ
钿	钅田丨
鼋	元口丨ㄋㄋ
缛	纟辰一丨丶
鲶	鱼今丶ㄋ
愍	民攵丶ㄋ
狎	犭甲丨ㄋ丨
髋	骨宀一丨
镢	钅厂丶ノ丶
镫	钅登ㄋ丶
郴	林阝ㄋ丨
槎	木一丨一
膻	月亠丨ㄋ
骜	敖马ㄋㄋ
羟	轻ㄋ丶一
遒	酋辶丶ㄋ丶丶
瘛	疒丰ㄋノ丶
茱	艹丿一一丶
娌	女里丨
浠	氵希ノ丶
蹼	业丶ノ
虼	虫ㄋ
枋	木方丶一
碚	石立丨ㄋ
禳	礻襄丶
醪	酉羽ノ丶
臁	月广丶ノ丶
劬	句力ㄋノノ
佻	亻儿丶
黩	黑十ㄋ
葩	艹白ㄋ丨ㄋ
莠	艹禾ㄋノ
芗	艹乡ㄋㄋ
餍	厂犬ノ丶
鄣	音十ㄋ丨
挲	氵小ノノ丨
鲎	学鱼ノㄋ一
髁	骨日一丨丶
洙	氵丿一一丶丶
鲢	鱼车丶ㄋ
芎	艹弓ㄋ一
娆	女尧一ㄋ
祇	礻氏ノㄋ
绀	纟甘一丨一
纡	纟于一一丨
铵	钅宀ㄋ
哔	口比一丨丨
讦	讠干一一丨
笳	加ㄋノ
胍	月瓜ノノ
跏	加ㄋノ一
芫	艹元ノㄋㄋ
阍	门氏丨
糁	米叁ノノ
嫠	未攵一ノ
鳏	鱼罒丨
勐	子皿ㄋノ
鬻	弓米ㄋ一丨
廪	广亠丨ㄋ丶
墀	土尸丨
鳕	鱼雨ㄋ一
蟊	矛虫丨ㄋ
厣	厂犬丨
狷	犭口丨ㄋ
帏	巾韦一一丨
嫱	女十丶ノ
韪	是韦一一丨丨
彀	壳一ㄋ一
擀	扌ノ丶
蠓	虫劳一一丶
佰	亻百一ノ
郗	希阝ㄋ丨丨
芏	艹土一丨一
铆	钅卯ㄋ丨
钒	钅凡ノㄋ丶
嘧	口宀丶ㄋ丨
睇	目弟丶
屙	尸阝一丨丨
饫	饣夭ノ
裰	衤双ㄋ丶丶
菸	艹方ノ
藿	艹雨ノ丨一
聩	耳贵丨
濉	氵目ノ丨一
坨	土宀ノㄋㄋ
垭	土亚一丨
龆	齿召ㄋノ一
鹚	䒑幺ㄋㄋ一一
芄	艹九丶丶丶
仞	亻刀丶丶
缬	纟吉一ノ
桁	木彳一一丨
褫	衤丨一
鏊	敖金ノ丶
踔	卓丨一
萸	艹臼ノ丶
绔	纟大一一ㄋ
眇	目小ノノ
洮	氵儿丶一
饩	饣气ノ一
腚	月定丶丶
菅	艹宀丨ㄋ一一
蚧	虫人ノ
侩	亻人一一丶
仟	亻千ノ一
嘞	口革ㄋノ
妯	女由丨ㄋ
莴	艹呙丨ㄋ
鞫	革勹丶一
镒	钅䒑ノ丶
诔	讠耒一一丶
绱	纟尚丨丶
勰	力力ㄋノ
枇	木比一ㄋㄋ
杷	木巴ㄋ丨ㄋ
囟	囟㐅ノ丶
澶	氵亠丨ㄋ一
怄	忄区一ノㄋ
垅	土龙一ノ
篑	贵丨ㄋ
锒	钅良丶ㄋ
嘌	口覀一一
溧	氵覀一丨丶
笾	力丶
鸹	舌鸟ノㄋ
矽	石夕ノㄋ
擤	扌自丨ㄋ丨
珩	王彳一一丨
痼	疒囗一丨
芡	艹欠ノㄋ丶
苕	艹召ㄋノ
煅	火段ノ丨丶
锶	钅田丶
枳	木口ノ丶
嵊	山禾丨一
撺	扌穴丨ㄋ丨
贽	执贝丨ㄋ
袢	衤半丶ノ丨丨
逄	夂㐄丶ㄋ丶丶
蚋	虫内丨ㄋ
呋	口夫一一
黾	口日ㄋㄋ
樗	木雨一一ㄋ
讧	讠工一丨
亳	亮乇ノ一
跆	台ㄋ丶一
蜍	虫余ノ丶
砉	丰石一ノ
縻	麻糸ㄋㄋ
阌	门受ㄋ丶
桉	木宀ㄋ
幂	冖日一ノ
瞽	壴十ㄋ丶
祢	礻尔ノㄋ丶
怫	忄弓ノ
囵	囗八ノㄋㄋ
虺	兀虫丨ㄋ
傈	亻覀一丨
囹	囗令ノ丶丶
肼	月井一一
簟	覀丨
魈	鬼肖丨丶一
旯	日九ノㄋ
衿	衤今ノ丶
朐	月句ノㄋ
腭	月吅一一
卮	一ㄋㄋ
笪	旦丨ㄋ一一
荛	艹尧一ㄋ
闫	门三一
睚	目厂一丨
滁	氵阝ノ丶
忪	忄公ノ丶
箧	匚一丶
侔	亻厶ノ一丨
侪	亻文ノ丨
镊	钅耳ㄋ丶
雎	且隹ノ丨一一
汊	氵又丶丶
泫	氵玄丶一丶
悒	忄口ㄋ丨
堀	土尸ㄋ
趸	万足丨ㄋ丶
裢	衤车丶ㄋ
貉	豸各ノㄋ
獒	敖犬一ノ丶
笸	匚丨ㄋ
跎	宀ノㄋㄋ
阃	门囗一丨丶
鳟	鱼酋一丨丶丶
黢	黑夋ㄋ丶丶
喁	口禺丨ㄋ丶
榧	木匚丨一
牖	片户一丨丶
渑	氵口丨ㄋ一一
筮	工ノ丶
徜	彳尚丨丶
餮	歹㐱ノ丶丶
佤	亻瓦一ㄋ
缶	缶ノ一丨
庥	广亻一
嗍	口屰ノㄋ
枥	木厂ㄋノ
箝	扌一丨一
镛	钅广ㄋ一
糅	米矛一丨丶
驽	奴马ㄋㄋ
峄	山又一一丨
罴	罒去丶丶
拊	扌付ノ丨丶
螈	虫厂ノ丨
蜢	虫子丨ㄋ一
倬	亻卓丨一
嗉	口ㄋㄋ
柘	木石一ノ
綦	其糸ㄋㄋ
昀	日勹丶一
浯	氵五丨ㄋ
馓	饣丨ㄋ丶
堋	土月ノㄋ
茴	艹回丨ㄋ
蟛	虫壴ノノ
唿	口勿丶ㄋ
柢	木氏丶丶
擘	辟手ノ一
饴	饣台ㄋ丶
鸱	氏丶ノㄋ一
嘏	古叚ㄋ一丶
冼	冫先ノ一
栀	木一ㄋㄋ
堇	堇一丨一
氘	气ノ丨
氪	气古ノㄋㄋ
搿	合ノ一
苎	艹㝉丶丶一
咴	口丶ノ丶
岿	山ㄋ一
硌	石各ノㄋ一
裾	衤尸一丨一
醢	酉丨ㄋ一
笊	爪ノノ
寤	宀爿一丨
倥	亻穴一丨一
碓	石隹ノ
袷	衤合ノ丶一
醚	酉米丶ㄋ
舻	舟⺊ㄋ一
郃	合阝ㄋ丨
跹	千丶ㄋ丶
跞	丨ノ
鹕	古月ノㄋ
髂	骨宀ノㄋ一
楮	木者一丨一
珐	王去一丨丶
荏	荷壬ノ一一
苴	艹且丨ㄋ
铄	钅丨ノ
砩	石弓ノ丨
矬	矢从一丨一一
膈	月鬲一丨丨
艏	舟䒑ノ丨
螯	敖虫丨ㄋ丶
瘘	疒米ㄋノ
帙	巾丿一一丶丶
桡	木尧一ㄋㄋㄋ
圮	土己ㄋ一
诎	讠出ㄋ丨
旆	族一丨ㄋ
苄	艹丶一丨丶
芰	艹十ㄋ丶丶
缒	纟ノ
锑	钅弟丶ノ
潴	氵犭一丨一一
溆	氵余ㄋ丶丶
粳	米更一丨丶
椴	木段ノ丨
悭	忄坚一丨
鹂	丽鸟ノㄋ
刖	月刂丨丨
陟	阝止丨ノ
莸	艹犭一ノㄋ
熘	火留丨ㄋ
锕	钅阝一
啁	口冂一丨一
鹩	尞鸟ノㄋ一
滟	氵丰ノㄋㄋ
雠	隹讠ノ丨
疝	疒山丨ㄋ
嗾	口族ノ一丶丶
哞	口厶ノ一
鲋	鱼付ノ
鹆	谷鸟ノㄋ一
赅	贝亥丶一丶
肄	匕矢ㄋ一
蠊	虫广丶ノ丶
蛱	虫夹ノ丶
匏	大亏ノㄋㄋ
奁	大区一ノ
稞	禾日一丨丶
鼬	鼠由丨ㄋ
崤	山㐅一ノ
裣	衤佥ノ丶一
疖	疒卩ㄋ丨
芟	艹殳ノㄋ丶
炝	火仓ノ丶
籴	入米丶
砀	石汤ㄋノ
怙	忄古一丨一
硷	石佥ノ丶一
蜮	虫戈丨ㄋ一
硪	石我ノ一
愀	忄禾丶ノ
鳊	鱼户丨ㄋ丨
跗	付ノ丨
蹉	一丨一
痍	疒大ㄋ一
蔻	艹宀一一丶
苤	艹不一一
僳	亻覀丶ノ
沆	氵亠ノㄋㄋ
崾	山覀ㄋノ
卣	⺊囗ㄋ
踯	䒑一ノ
薜	艹辟ㄋ一
獯	犭千丨ㄋ丶
嗌	口䒑ノ丶一
崃	山夹丨ノ
韫	韦日丨ㄋ一一
醍	酉是丨ㄋ丶
雱	雨方丶
艉	舟尸ノ一
訇	勹言丶一
瘿	疒贝丨ㄋ一
僦	亻京一ノ丶
猢	犭古ノㄋ
缯	纟曾丶ノ
嫒	女受一
浞	氵足丨ㄋ丶
畛	田㐱ノ丶ノ
鄄	覀土ㄋ丨
徉	彳羊丶ノ丨
獬	犭角ㄋ
鞴	革ノノ
锸	钅千ノ丨
尕	乃小丨ノ
嬖	辟女ㄋノ
硐	石冂一丨
怛	忄旦丨ㄋ
鼍	吅田一ㄋ
脲	月尸丨
胨	月东一ㄋ
佶	亻吉一丨
噻	口寒一丨一一
槲	木角丶丶
婧	女青一
乇	乇ノ一ㄋ
涑	氵束一丨
埙	土口丨ㄋ丶
缃	纟相一
嵴	山ノ丶
谰	讠门一丨丶丶
狲	犭孑丨ノ
铧	钅华ノㄋ
钪	钅亠ノㄋㄋ
粜	出米丶ノ
晷	日夂丨
笱	句ノ
狯	犭人一一
榇	木立一丨丶丶
畈	田ㄋ丶
逦	丽辶丶ㄋ
鲅	鱼ㄋ丶丶
鲱	鱼非丨一一
膂	族丨ㄋ一
焐	火五丨ㄋ一
锛	钅大一丨丨
凼	水凵ㄋ丨丨
珲	王冖一
圄	囗五丨ㄋ一一
肫	月屯一ㄋ
癯	疒目丨ㄋ一
猱	犭矛一丨丶
盱	目于一一丨
昴	日卯ㄋ丨
觳	壳一ノㄋ丶
伧	亻仓ノ丶
椁	木享丶一
劢	万力ㄋノノ
鲮	鱼土ノ
笄	开一一
宄	宀九ノㄋ
荠	艹文ノ丨
伥	亻长ノ一丶
厍	厂车一ㄋ丨
蛘	虫羊丶ノ丨
砻	龙石一ノ一
塬	土厂ノ丨
鹨	羽㐱ノㄋ
菽	艹上丨ノ
轳	车⺊ㄋ一
倮	亻日一丨丶
铖	钅戊ㄋㄋ
锆	钅告ノ一
钼	钅目丨ㄋ
氡	气夂丶丶
挹	扌口ㄋ丨
亓	一丌一ノ
胗	月㐱ノ丶
儋	亻厃ノ丶一
郾	匚日ㄋノ
鞒	革夭ノ丨
鹁	孛子ノ
捌	扌另丨丨
焯	火卓丨一
锗	钅者一丨
嚯	口雨ノ丨
鲠	鱼更一丨
枵	木口一ㄋ
盍	去皿丨ㄋ
硗	石尧一ㄋㄋ
兕	凹儿ノㄋ
畚	叁田丨
虿	万虫丨ㄋ
肟	月亏一
陉	阝轻ㄋ丶一
隳	阝一丨丶
熳	火日丨ㄋ一
嘬	口日一丨丶
杓	木勹丶丶
檩	木亠丨ㄋ丶丶
邨	屯阝ㄋ丨丨
黼	业丷丨
裥	衤门丨ㄋ一
鲰	鱼耳ㄋ丶
狍	犭勹ㄋ一
垓	土亥丶一丶
鬯	㐅灬ㄋ丨ㄋ
赀	此贝丨ㄋ丶
龀	齿匕ノㄋㄋㄋ
跣	先ノ一
蜉	虫爫ㄋ
瓠	大亏ノノ
缱	纟中一
镧	钅门一丨丶
锩	钅ㄋㄋ
澍	氵壴一丨丶
馃	饣日一丨丶丶
碡	石ㄋㄋ
诶	讠厶ノ一
鸫	东鸟ノㄋ一
篪	丨一ㄋ
蹚	一丨一
鬟	髟罒丨ㄋ丶
蛑	虫厶ノ一
煸	火户丨ㄋ丨
孑	孑ㄋ丨
茔	劳土一丨
耪	耒帝丶一
罘	罒不一ノ
绲	纟日一ㄋ
嵯	山一丨一一
谇	讠卒丶一丨
菹	落且丨ㄋ一
菔	艹月ㄋ丨
聃	耳冉丨ㄋ一
镞	钅族ノ一
戆	音十ノㄋ丶
炅	日火丶ノ丶
慊	忄兼丶ノ
莼	艹纟一ㄋ
辚	车米ノㄋ丨
呖	口厂ㄋノ
唢	口丨ㄋ丶丶
砗	石车一ㄋ丨
胼	月䒑一ノ丨
萋	艹妻ㄋノ
傧	亻宀ノ丨
铍	钅皮ㄋノ丶
赉	夹来丨ㄋ
鼙	壴十ㄋ丶丨
扦	扌千ノ一丨
楸	木禾丶
洳	氵女丨ㄋ一
鲀	鱼屯一ㄋㄋ
羰	山一ノ
躅	罒ノㄋ
蘩	艹每ノ一丶丶
萘	艹大一一丶
钕	钅女ㄋ
戗	仓戈一ㄋ丶
嶝	山登ㄋ丶
摭	扌度丶丶
鲡	鱼丽一丨
蘖	艹丶一丶
堞	土世一丨
诼	讠豕丶
胂	月日丨丨
篁	白一一
蚬	虫见丨
钲	钅正一丨
钋	钅卜丨丶
芤	艹孑ㄋㄋ
镆	钅莫一丨丶
啉	口林一丨丶
楝	木柬一
疃	田立丨ㄋ一
呒	口一一ノ
鸶	一ノ
痱	疒非丨一一
缣	纟兼丶
阊	门日丨ㄋ一一
楦	木㝉丨ㄋ
畀	畀丨ㄋ丨
葎	艹彳ㄋ一
垡	亻戈一丨一
骱	骨人ノ丨丨
脔	亦内ノ
舨	舟ㄋ丶
羧	夋ㄋ
颎	匕火一ノ
葑	艹圭一丨
蜣	虫羊ノㄋ
偾	亻十一丨丶
髑	骨罒ノㄋ
廛	广里ノ丶一
钣	钅ㄋ丶
镔	钅宀ノ丨
瓴	令瓦一ㄋ
畋	田攵ノ一
迓	牙辶丶ㄋ丶
踟	矢丨
痧	疒氵丨
艽	艹九ノㄋ
蠛	虫萝一ノ
蛏	虫又一丨一
殄	歹㐱ノ丶ノ
鼗	儿一丨丶丶
黧	禾勹ノ丨丶
帔	巾皮ㄋ
驺	马刍ノㄋ
崞	山享丶一一
窳	穴瓜ノノ
逑	求辶丶ㄋ丶丶
醣	酉广ㄋ一
喾	学告ノ一
麸	夂一
蹰	厂一丨丶
髌	骨宀ノ丨丶
秫	禾木丶
邰	台阝ㄋ丨丨
罟	罒古一丨一一
甙	弋甘一丨一一
欹	大可ノㄋ
岵	山古一丨一一
硖	石夹丨ノ
裎	衤口一一一
骘	阝止丨ノ一
蓼	艹羽ノ丶
幛	巾音一丨丨
镬	钅艹ノ丨
钎	钅千ノ一
暝	日冖丨ㄋ丶丶
暌	日癸ㄋ丶丶
愦	忄贵丨ㄋ
窀	穴屯一ㄋㄋ
鹈	弟鸟ノㄋ一
薹	艹吉丶ㄋ一
蚍	虫比一ㄋ
蚶	虫甘一丨一
钭	钅⺀一
粝	米厂一ㄋノ
孥	奴子ㄋ丨
衄	丿皿ㄋ丨
泔	氵甘一丨一
溘	氵去丨ㄋ一一
圉	囗土丶ノ
肷	月欠ノㄋ丶
箪	单丶
荽	艹爫ㄋノ一
跫	工凡丨ㄋ丶
嫘	女田ㄋ
曩	日襄丶一丶
裉	衤艮ㄋ一
酃	雨吅丨ㄋ丨
皤	白番ノ丶
莪	艹我ノ一
粢	次米丶ノ
睃	目夋ㄋ丶
裼	衤日ノㄋ
脘	月宀一一
旒	族㐬丶一
疴	疒可一
螬	虫曹一丨
哌	口ノㄋ丶丶
鐾	辟金ノ丶一
瀣	氵⺊ノㄋ
殳	殳ノㄋ
谵	讠厃ノ丶一
甯	宀心丨ㄋ一
疠	疒万一ㄋ
蚰	虫由丨ㄋ
彘	彑匕ノ一
钌	钅了ㄋ
鄞	堇阝ㄋ丨
罾	罒曾丶ノ一
醵	酉虍一ノ丶
鳢	鱼曲一丨一
鳔	鱼覀一一
胙	月乍ノ一
隹	隹ノ丨
蝽	虫丨ㄋ一一
虮	虫几ノㄋ
鹪	隹灬ノ
蕖	落匚一ㄋㄋ
萑	艹隹ノ丨
绨	纟弟丶
锱	钅巛丨
钫	钅方丶
罱	罒十丨ㄋ丨
璁	王囟ノㄋ丶
玎	王丁一丨丨
旄	族毛ノ一ㄋ
篦	囟ノ丶
跖	石一ノ一一
煳	火古ノㄋ
榱	木哀一ノ
濞	氵自丨ㄋ丨
砹	石艹ノ丶
悱	忄非丨一
尥	尢勹丶丶
螽	夂⺀丨ㄋ
辊	车日一ㄋ
磴	石登ㄋ
捩	扌户一ノ丶
瑷	王受一
窨	穴音丶
褊	衤户丨ㄋ丨
貔	豸囟ノ丶
逯	录辶丶ㄋ丶丶
蘼	艹麻丨一
糗	米自一ノ丶
嵝	山米ㄋノ
憷	忄林ㄋ丨
鳚	鱼尸一一
蝣	虫族ㄋ
麇	鹿禾ノ一
曛	日千丨ㄋ
肜	月彡ノノ
艨	舟劳一一丶
筇	工ㄋ丨
逭	宀㠯丶ㄋ
癔	疒音丶
轫	车刀丶丶
湔	氵前丶ノ丨
沔	氵正ㄋㄋ
嬲	田力ㄋ
玢	王分ノ丶
袼	衤各ノㄋ一
醐	酉古ノㄋ
鹾	⺊囗ノ丶
猡	犭罒ノㄋ
髀	骨卑ノ丨
庀	广匕ノㄋ
钯	钅巴ㄋ丨
槔	木白一ノ
遄	山而丶ㄋ
皴	夋皮ㄋノ
泶	学水丨ㄋ
蹀	世一
敫	白方ノ一丶
苊	艹厂ㄋㄋ
蒌	艹米ㄋノ一
蛲	虫尧一ㄋㄋ
泮	氵半丶ノ
朊	月二ノㄋ
薅	艹女一ノ
犸	犭马ㄋ
銎	工凡ノ丶
浼	氵免ノㄋㄋ
祆	礻夭ノ一丶
窭	穴米ㄋ
酽	酉亚ノノノ
鲔	鱼丨ㄋ一
獍	犭音ノㄋㄋ
缡	纟㐫丨ㄋ丶
喱	口厂丨ㄋ一
樘	木一丨一一
湓	氵分丨ㄋ一
嵛	山俞ノ丶丨
捭	扌卑ノ丨
迕	十丶ㄋ
藁	艹高一丨丶
瞋	目直ノ丶
酐	酉干一一
葚	艹其ㄋㄋ
偬	亻勿丶丶丶
侉	亻大一一
鹱	鸟艹ノ丨
鲃	鱼巴ㄋ丨
肭	月内丨ㄋ
篯	钅一一
褰	寒衣丶一
搴	寒手ノ一丨
莩	艹爫ㄋ丨
芑	艹己ㄋ一ㄋ
铋	钅必丶ㄋ丶
糇	米亻ノ丨丶
渖	氵宀丨ㄋ丨丨
砬	石立丶一
璩	王虍一ノ丶丶
舾	舟西一丨
甾	巛田丨ㄋ
仫	亻丿ㄋ丶
杪	木小ノノ
漯	氵田ㄋㄋ
鳙	鱼广ㄋ一
鞔	革免ノㄋ
庹	度尺ㄋ一
铯	钅ㄋ丨ㄋ
锊	钅爫一
籼	米山丨ㄋ丨
戥	日生一ㄋ
溏	氵广ㄋ一
岣	山句ノㄋ
穸	穴夕ノㄋ丶丶
酡	酉宀ノㄋㄋ
锼	钅臼丨丨
铒	钅耳一丨
钇	钅乙ㄋㄋ
敉	米攵ノ一丶丶
燹	豕豕丶ノ
醭	酉业丶ノ
鲚	鱼文ノ丨丨丨
豉	豆十ㄋ丶
锜	钅大一丨丨丨
哏	口艮ㄋ一
磙	石六ㄋ丶
祕	礻必丶ㄋ丶
菘	艹木ノ丶
茭	艹交丶一
镗	钅一丨一
锿	钅哀ノㄋ
钔	钅门丶丨
骢	马囟ノㄋ丶
琚	王尸一丨一一
炻	火石一ノ一
炱	台火丶ノ
搠	扌屰ノㄋ一
隰	阝日ㄋ
菡	艹了丶一
鸺	亻木ノㄋ一
仡	亻ㄋㄋ
疳	广甘一丨一
垴	土㐫丶一丨
瓿	立口一ㄋ
刿	山夕丨丨
砜	石风ノㄋ
鳇	鱼白一一一
荸	艹孛ㄋ丨
缧	纟田ㄋㄋ
锝	钅日一一
栌	木⺊ㄋ一
桤	木山ㄋ一
溲	氵臼丨ㄋ丶
馇	饣木丨ㄋ一
鹮	罒同ノㄋ
艚	舟曹一丨
殍	歹爫ㄋ丨一
仵	亻一丨丨
嶷	山疑ノㄋ丶
羼	尸羊丶ノ丨丨
谂	讠今丶
鲷	鱼冂一丨一一
葜	艹丰ㄋノ丶
煺	火艮丶ㄋ
铑	钅耂ノㄋ
镅	钅丨ㄋ
吣	口心丶ㄋ丶
氙	气山丨ㄋ丨
硭	石艹丶一ㄋ
窬	穴俞ノ丶
筌	人一一一
蒴	艹屰ノㄋ一
蟥	虫丨
鸸	而鸟ノㄋ
哿	加可一丨
窆	穴丿丶ㄋ
蒡	艹帝丶一
苒	艹冉丨ㄋ
橥	犭者一丨丶
鞲	革冓一一
锍	钅㐬丶一ㄋ
甓	辟瓦一ㄋ
硇	石囟ノ丶
爨	𦥑冂丨ㄋ丶
鸲	句鸟ノㄋ一一
辂	车各ノ
喹	口大一丨一一
跶	大丶ㄋ
檠	艹句ノ一丶丶
髟	髟一丨ノ
镓	钅宀一ノ
邴	丙人ㄋ丨丨
葳	艹戊一ㄋ
艟	舟立丨ㄋ一
铙	钅尧一ㄋ
涠	氵囗一一丨
锪	钅勿丶ㄋ
镄	钅弓ノ
蕤	艹豕ノ一
眬	目龙一ノ丶丶
胩	月上丨丶
翥	者者一丨一
耒	耒一一丶丶
箬	艹一ノ
躔	广丨ㄋ
黥	黑京丶一
谮	讠旡一ㄋ
戢	口耳一ㄋ
訾	此言丶一一
檑	木雨丨ㄋ一
襦	衤雨一ノ
歃	千臼ノㄋ丶
瘌	疒束丨丨
纛	母丨ㄋ丶
蓍	艹耂ノㄋ一
潋	氵佥ノ一
徼	彳白丶
杌	木兀一ノ
爿	爿ㄋ丨ノ
滹	氵虍ノ丶丨
芈	丨一丨一
郜	告阝ㄋ丨
狴	犭比一丨一一
謦	士ノㄋ一一
貅	豸亻一丨
眭	目圭一丨一
玟	王文丶一丶
嫫	女莫一丨
疋	疋ㄋ丨
娈	亦女ㄋノ一
搦	扌弓丶一
瑗	王爰ノ丶
殂	歹且丨
蕈	艹覀丨ㄋ
犴	犭干一一
绐	纟台ㄋ丶
糨	米弓丨ㄋ丶
柰	木示一一丶丶
沭	氵木丶丶
谳	讠十丨ㄋ
耋	耂匕一
怿	忄又一一
翮	鬲羽ㄋ丶
坻	土氏丶丶
骝	马留丨ㄋ一
阼	阝乍ノ
棹	木卓丨一
尻	尸九ノㄋㄋ
撄	扌贝丨ㄋ一一
侑	亻丨ㄋ一
洇	氵因丨ㄋ一
柒	氵七一丨丶丶
悝	忄里丨ㄋ
燠	火向丶
旰	日干一一丨
欷	希欠ノㄋ丶丶
媵	月ㄋノ
徂	彳且丨ㄋ一一
缵	纟先ノ一
澌	氵其ノノ丨
洎	氵自ノ丨一
坩	土甘一丨一一
裒	亠臼ノㄋ
廨	广角ㄋノ
镝	钅啇丶一一
耧	耒米ㄋノ
觇	占见丨ㄋ
轺	车召ㄋノ
崦	山大丨ㄋㄋ
霪	雨氵ノ丶一
剡	炎刂丨丨丨
觚	角瓜ノノ
喈	口比ノ丨
眚	生目丨ㄋ一
怍	忄乍ノ一
貊	豸百一
蓐	艹辰一丨
蒹	艹兼丶ノ
绂	纟ㄋ丶
哓	口尧一ㄋ
卺	丞㔾ㄋㄋ
棰	木垂ノ一一
悛	忄夋ㄋ
昝	夂卜丨ㄋ一
遘	冓辶丶ㄋ丶
瘗	疒夹ノ丶一
莳	艹日一丨丶
蚺	虫冉丨ㄋ一
栊	木龙一ノ丶丶
柙	木甲丨ㄋ丨
豳	山豕一ノ
嵫	山䒑ㄋ
蠃	赢虫丨ㄋ丶
鬲	鬲一丨丨
蓊	艹公ㄋ
蕞	艹日一丨一一
秭	禾弟ノㄋノ
幞	巾业丶
锞	钅日一丨丶丶
舁	臼廾一ノ丨
茕	劳一丨丨
邾	丿未ㄋ丨
滏	氵父一一一
雩	雨亏一一ㄋ
踣	立丨ㄋ一
蝰	虫大一丨一一
呙	呙丨ㄋ丶
梃	木壬ㄋ丶丶
腩	月十丨ㄋ
颟	艹丙ノ丶丶
蒽	艹因丶
轵	车口ノ
伛	亻区一ノ
缑	纟亻ノ丨
麈	鹿主丶一
骖	马叁ノノノ
仝	人工一丨一
暾	日享ノ
祧	礻儿丶一
堠	土亻ノ丨丶
黻	业米一ノ
陬	阝耳ㄋ丶丶
筅	先ノ一
蹁	户丨ㄋ丨丨
刳	大亏丨丨
缍	纟垂ノ一一
骟	马户ㄋ丶
桫	木氵丨ノ
悫	壳几丶ㄋ
豸	豸ノ丶ノ
隈	阝田一
荑	艹大ㄋ一
佾	亻八丨ㄋ
帻	巾丨ㄋ丶
哕	口山ノㄋ丶
荦	劳牛ノ一丨丨
糌	米夂丨丶
栳	木耂ノㄋ
栲	木耂一ㄋㄋㄋ
洧	氵丨ㄋ一
泺	氵丨ノ
剀	山己丨丨
攮	扌橐丨ㄋ丶
埸	土日ノ
埒	土爫一丨丶
赙	贝甫一丨
荇	艹彳一一丨
茌	荷士一丨
蛸	虫肖丨丶
犰	犭九ノ
铗	钅夹ノ丶
贳	世贝丨ㄋ
妣	女比一ㄋ
忭	忄丶一丨
圬	土亏一一ㄋ
颃	亠几一ノ
郄	乂ㄋ丶丨
鲥	鱼日一丨丶
擐	扌罒丨ㄋ丶
踬	一丨丶丶
瘳	疒羽ノ丶ノ
蘧	艹虍一ノ丶丶
慝	匚艹一ノ丶
邗	干阝ㄋ丨
丌	丌一ノ丨
唣	口白一ㄋㄋ
耜	耒㠯丨ㄋ
椟	木十ㄋ丶丶
郐	人云ㄋ丨
屣	尸彳丨一
塄	土罒丶一
圯	土巳ㄋ一ㄋ
趱	走先ノ一
簋	艮丨
郫	卑阝ㄋ丨
疔	疒丁一丨丨
仳	亻比一ㄋ
猞	犭舍ノ丶
锔	钅尸ㄋ丨
哚	口几一丨丶丶
蓥	劳金ノ丶
毽	毛聿ㄋ丶
檎	木人丶一
柽	木又一丨
柝	木斤丶丶
刭	轻刂丨丨丨丨
晡	日甫一
溷	氵囗一ノ
瀹	氵合丨ㄋ丨
惝	忄尚丨丶
掎	扌大一丨丨丨
坜	土厂ㄋノ
颡	又双一丨丶丶
劓	自畀丨丨
趑	走次丶一
陴	阝卑ノ丨丨
箜	穴一丨
癀	疒丨ㄋ丶
蓠	艹㐫丨
蓁	艹ノ一
葸	艹田丶ㄋ
缳	纟同ノㄋ
缌	纟田丶ㄋ
镪	钅弓丨ㄋ
镡	钅覀丨ㄋ丨
噍	口隹丶丶丶丶
叻	口力ㄋノノノ
骐	马其一丨丶丶
桴	木爫ㄋ丨
砑	石牙一ㄋノ
悃	忄囗一丨丶
絷	执糸ㄋㄋ丶
篚	匚丨一
跬	圭一丨一一
瘐	疒臼ノ丶
芘	艹比一ㄋㄋ
蕻	艹镸一丨丶
萁	艹其一丨
蜩	虫冂一丨一
殪	歹壳一
猁	犭禾丨丨丨丨
觋	工从丨
廑	广堇一丨
秕	禾比一ㄋ
扃	户冂丨ㄋ一
绁	纟世一丨ㄋ
镩	钅宀ノ丶丶
眄	目正ㄋㄋ
氍	目目ノ丨ㄋ
昃	日厂ノ丶丶丶
屦	尸彳丶ノ
礅	石享ノ一
怃	忄一一ノ
拶	扌巛ノㄋ丶
垧	土向丨ㄋ一
埴	土直一丨一
堙	土覀一丨
圹	土广丶一ノ
埭	土隶ㄋ一丶
酹	酉爫一丨
鳐	鱼爫ノ一丨
馘	䒑自一ㄋ
憝	享攵丶ㄋ
龠	合吅丨ㄋ
筚	比一丨丨
箨	扌ㄋ丶丨
郇	勹隹ㄋ
贶	贝口ノㄋㄋ
瘰	疒田ㄋㄋ丶丶
茳	落工一丨一
菰	艹孑ノノ
髹	髟亻一丨
髫	髟召ㄋノ
轹	车丨ノ
佴	亻耳一丨一
狺	犭言丶
黟	黑夕ノㄋ丶
镥	钅鱼丨ㄋ
铫	钅儿丶一
舄	臼勹丶丶
骀	马台ㄋ丶一
毳	毛毛ノ一
糍	米䒑ㄋㄋ
杩	木马ㄋㄋ一
牾	牜五丨ㄋ一
浍	氵人一一丶
溱	氵ノ一
矧	矢弓丨丨
掊	扌立丨ㄋ
撙	扌酋一丨丶丶
垆	土⺊ㄋ一
坼	土斤丶丶
珙	王共一丨丶
珉	王民ㄋ一
酤	酉古一丨一一
酎	酉寸一丨丶
觜	此角ノ
貘	豸莫一丨
陔	阝亥丶一
篼	白ノㄋㄋ
羝	氏丶丶丶
辋	车冂丶ノ
蝾	虫劳一丨
狃	犭丑ㄋ丨
戽	户⺀一丨
綮	户攵ㄋㄋ
彖	彖ㄋㄋ
绗	纟彳一一
镟	钅族丨一
栝	木舌ノ一
枘	木内丨ㄋ
皲	冖车ㄋノ
溽	氵辰一丨丶
沩	氵为丶ノ丶
岈	山牙一ㄋノ
觌	十买丨ㄋㄋ
摅	扌虍丶ㄋ
揸	扌木丨
揎	扌㝉丨ㄋ一一
埝	土今丶ㄋ
岙	夭山丨ㄋ丨
瞀	矛攵丨
艋	舟子丨ㄋ
舳	舟由丨ㄋ
筲	肖丨丶一
趵	勹丶丶
跽	己丶
趼	开一一丨
疬	疒厂ㄋノノ
瘼	疒莫一丨
痦	疒五丨ㄋ
荜	艹比一丨丨丨
茆	艹卯ㄋ丨丨
蕺	艹口一丨丶丶
薤	艹歹丨一
萆	艹卑ノ丨
蔸	艹白ノ丨一
茛	艹艮ㄋ一丶
蝤	虫酋丶
狳	犭余ノ丶
爝	火爫丨ㄋ丶
鹣	兼鸟ノㄋ一一
镲	钅宀ノㄋ丶丶
铊	钅宀ノㄋㄋ
鹇	门木ノㄋ一
糈	米疋丨ㄋ
檫	木宀ノㄋ丶
柁	木宀ノㄋㄋ
洫	氵丿丨ㄋ一一
祓	礻ㄋ丶丶
忮	忄十ㄋ丶丶
畎	田犬一ノ丶
坫	土占丨一一
埕	土口一一
珧	王儿丶一
襻	衤木ノ丶
醅	酉立丨ㄋ一
鳜	鱼厂丶ノ丶丶
鲵	鱼臼ノㄋ
鲼	鱼十一丨
阽	阝占丨一
黉	学丨ㄋ丶丶
觏	冓见丨ㄋㄋ
鳘	每攵ノㄋ一
聱	敖耳一丨一
篌	亻ノ丨
箅	畀丨ㄋ丨丨
箦	丨ㄋ丶
籀	扌ノㄋ一
躜	先ノ一丶
躐	巛丨ㄋ
赆	贝尺丶丶丶丶
赇	贝求一丨丶
瘊	疒亻ノ丨
瞢	萝目丨
甍	萝冖一ㄋ
蔟	艹族ノ一
蒉	艹贵丨ㄋ
葶	艹亮一丨丨
莨	艹良丶ㄋ
劂	厂屰ノㄋ
蝻	虫十丨ㄋ丨丨
仉	亻几ノㄋㄋ
狁	犭厶ノ
邡	方阝ㄋ丨丨丨
坌	分土一丨一
戋	戋一一
绠	纟更一丨丶
纩	纟广丶一
帱	巾一丨丶丶
孓	了丶丶丶
棼	林分ノ丶ノ
枧	木见丨ㄋㄋ
桄	木光丨丶
桷	木角ノㄋ丨
眙	目台ㄋ丶
妁	女勹丶丶
澉	氵敢ノ一丶
汔	氵ㄋㄋ
漭	氵艹一ノ
漶	氵口丨ㄋ一一
滠	氵耳ㄋ丶丶
淠	氵畀丨ㄋ丨
忉	忄刀ㄋノ
揠	扌匚丨ㄋ
挢	扌夭ノ丨
坶	土母ㄋㄋ
坭	土尸ノㄋㄋ
埤	土卑ノ丨
垲	土山ㄋ一
鲽	鱼世一丨
毹	俞毛ノ一
腠	月ノ一
脞	月从一丨一
璺	𦥑冂丨ㄋ丶丶
邶	北阝ㄋ
簏	鹿丶一ㄋ
鲞	鱼ノㄋ
瘵	疒祭ノㄋ丶
蔌	艹束ノㄋ丶丶
鬏	髟禾丶ノ
轾	车至一ㄋ
儇	亻同ノㄋ丶
豇	豆工一丨
恧	而心丶ㄋ
猃	犭佥ノ丶
顸	干页一ノ丶丶
缲	纟口丨ㄋ丶
觖	角夬ㄋ一丶
镙	钅田ㄋㄋ
锬	钅炎丶ノ
锾	钅爰ノ丶
鼷	鼠爫ㄋㄋ
骒	马日一丨丶丶
楗	木聿ㄋ丶
樨	木尸丨丶
柃	木令ノ丶丶
襞	辟衣丶
檗	辟木一丨丶
氽	人水丨ㄋ丶
溻	氵日ㄋ丶
屺	山已ㄋ一
岜	山巴ㄋ丨
磲	石氵一ㄋ
甏	壴彡一
禊	礻丰ㄋノ
毵	叁彡ノ一
攉	扌雨ノ丨一
擗	扌辟ㄋ一丨
揲	扌世一丨丶
搛	扌兼丶ノ
埏	土丿丨一
垌	土冂一丨
墁	土日丨ㄋ丶
黹	业丷丨ㄋ
褙	衤北丨ㄋ
酾	酉丽一丨
鲭	鱼青一一
蝥	矛攵丨ㄋ
腈	月青一一一
塍	月一丨一一
脬	月爫ㄋ丨
腧	月俞ノ丶
舴	舟乍ノ一
舯	舟中丨ㄋ
舡	舟工一丨一
鹛	目ノㄋ一
篥	覀一丨
桊	木一丨
癍	疒王丶一
癃	疒阝ノㄋ一
瘥	疒一丨一一
瘅	疒单丶ノ
茚	艹ㄋ丨
蓰	艹彳丨一丶
芴	艹勿ノㄋ
莛	艹壬ㄋ丶
茼	艹冂一丨
蒇	艹戊丨ㄋ丶丶
茺	艹ノㄋㄋ
萏	艹ノ丨
椠	车斤一丨丶
墼	車凵ノ
蝓	虫俞
剞	大可丨丨丨丨
夼	大川ノ丨
佧	亻上丨丶
傺	亻祭ノㄋ丶丶
俜	亻由一ㄋ
僬	亻隹丶丶丶
恝	丰刀丶ㄋ
廒	广敖一一
庳	广卑ノ丨
飑	风勹ㄋ一ㄋ
缋	纟贵丨ㄋ丶
绋	纟弓ノ丨丨
铴	钅氵ㄋノ
钬	钅火丶
钐	钅彡ノノ
锇	钅我ノ一
鼢	鼠分ノ丶
哳	口折一丨丨
唪	口一一
唼	口立ㄋノ
耩	耒冓一一
氆	毛並丨ㄋ一
橼	木纟ㄋㄋ丶
椐	木尸一丨
椹	木其ㄋㄋㄋ
枨	木长ノ一丶
瞵	目米ノ
瞍	目臼丨
眍	目区一ノ
汆	入水丨ㄋ丶丶
泖	氵卯ㄋ丨
潲	氵禾丨
泐	氵阝ㄋノ
浈	氵⺊丨ㄋ丶
瀵	氵米丨ㄋ丶丶
渫	氵世一丨丶
岽	山东一ㄋ
礓	石一丨ㄋ一
碹	石㝉丨ㄋ一
砘	石屯一ㄋㄋ
罨	罒大丨
搌	扌尸一丨丶
捃	扌尹丨ㄋ
堍	土免丶丶
垸	土宀一一ㄋ
埚	土呙丨ㄋ丶
眢	夗目丨ㄋ一一
酞	酉大丶丶丶
酴	酉余ノ丶
酲	酉口一一一
鲳	鱼日丨ㄋ一
霈	雨氵一丨丨
臌	月壴一
膣	月穴一ㄋ
舣	舟丶ノ丶
劁	隹灬丨丨
陧	阝日一丨
筢	扌ㄋ丨
箢	宀ノㄋㄋ
筻	更一丨丶
踺	聿ㄋ丶
躞	火丶一丶
蹯	番ノ丶
冁	单尸一丨丶
赕	贝炎丶ノ丶
瘕	疒叚ㄋ一
痖	疒亚一丨一
菝	艹扌一ノノ
茈	艹此丨一ㄋ
苘	艹冂丨ㄋ一
苈	艹厂ㄋノ
蕹	艹亠ㄋㄋ
薷	艹雨一ノ丨
蜞	虫其一丨丶
蜾	虫日一丨丶
仂	亻力ㄋノ
猹	犭木丨ㄋ
艴	弓ノㄋ
瓞	瓜丿一一丶丶
稂	禾良丶ㄋ
稆	禾口丨ㄋ一
烀	火乎ノ丶丨
觫	角束一丨
镦	钅享ノ一
锖	钅青一
锓	钅彐丶
铞	钅口丨ㄋ丨丨
锫	钅立丨ㄋ一
钽	钅旦丨ㄋ
镘	钅日丨ㄋ丶
铼	钅夹丨ノ
鼯	鼠五丨ㄋ
哜	口文ノ丨丨
冱	冫一ㄋㄋ
骣	马尸ㄋ丨
驵	马且丨ㄋ一
粞	米西一丨一
楱	木一一丶丶
榍	木尸丨丶一
桕	木臼ノ丨一
槠	木讠一丨一一
眵	目夕ノㄋ丶丶
犋	牜ノ丶丶
牿	牜告ノ一
胬	奴又丨ㄋ
嫜	女音一丨
洚	氵夂一ㄋ丨
滗	氵ノ一
岍	山开一一
砼	石人一丨一
砟	石乍ノ一
掭	扌天丨丶
揞	扌立丨ㄋ一
垤	土至一ㄋ
尜	小大丨ノ
谫	讠前ㄋノ
醑	酉疋丨ㄋ一一
鳆	鱼丨ㄋ丶
鲣	鱼坚一丨一
鲻	鱼巛丨ㄋ一
鲒	鱼吉一丨一
鲐	鱼台ㄋ丶一一
鲦	鱼夂一丨丶
颥	雨而一ノ
胲	月亥丶一
迮	乍辶丶ㄋ丶
薿	艹疑ノㄋ丶
嬛	女罒丨ㄋ丶
澴	氵罒丨ㄋ丶丶
醾	酉麻丶ノ
巇	山虍一丨
飏	风汤ㄋノノ
飗	风留丨ㄋ一
飐	风占丨
攴	⺊又ㄋ丶丶
郿	目ㄋ丨
鄗	高阝ㄋ丨丨丨
勍	京力ㄋ
遆	帝巾丶ㄋ
鹠	留田ノㄋ
弇	合廾一ノ丨
畬	余田丨ㄋ一
鹡	人丨ㄋ一一
坉	屯一ㄋ
坋	分ノ丶
坰	冂丨ㄋ一
垯	大丶ㄋ
垱	ㄋ一一
埆	角ノㄋ
埇	甬ㄋ
埼	大一丨丨
堎	夋ㄋ丶
堨	曷丨ㄋㄋ
塝	帝丶一
墈	其ㄋㄋ
墦	番ノ丶一
虒	虍ノㄋ
郈	同ㄋ丨
垕	同一丨一
翃	厶ㄋ丶一
鹐	臼ノㄋ一
麹	夂ノㄋ丶丶
黇	由ノ丶一
酂	先先丨ㄋ
簖	米ㄋノ丨
筘	扌丨ㄋ一
筦	宀一一ㄋ
簰	片ノ丨
筼	口丨ㄋ
簃	禾ノㄋ
簕	革ㄋノ
筥	口丨ㄋ一
簠	甫丨ㄋ一
簝	尞一ノ丶
筜	ㄋ一
筀	圭一丨一
鲝	鱼ノㄋ一一
羖	殳ノㄋ丶
羑	久ノ
蹐	ノ丶
跐	此丨一ㄋ
蹅	木丨ㄋ一
踦	大一丨丨
蹾	享ノ一
跂	十ㄋ丶丶
蹽	尞一ノ
踶	是丨ㄋ
蹜	宀ノ丨一
踒	禾ㄋ
郤	谷阝ㄋ丨丨
鹟	公羽ノㄋ
鹎	卑鸟ノㄋ
雊	句隹ノ丨
宧	宀一丨一
赒	贝冂一丨一
赗	贝日丨ㄋ一
赑	贝贝丨ㄋ丶
痃	疒玄丶一丶
疰	疒主丶一
瘭	疒覀一一丶
瘃	疒豕丶丶
痄	疒乍ノ一
瘆	疒叁ノノ
戣	癸戈一ㄋ
茇	艹ㄋ
劐	艹隹ㄋ丶
鹋	艹田ノㄋ
蔹	艹佥ノ一
莰	艹土ノㄋ丶
荮	艹纟一丨丶
萜	艹巾丨一
菥	艹木ノノ
葙	艹相一
蒗	落良丶ㄋ丶
蒎	落ノㄋ丶
蓣	艹予一ノ丶
蒈	艹比ノ丨
菪	艹宀一ノ一
莶	艹佥ノ丶一
荬	艹买ㄋ丶
苠	艹民ㄋ一
蕰	落日丨ㄋ一一
茀	艹弓ノ
蔀	艹立丨ㄋ丨
萩	艹禾丶ノ
苾	艹必丶ㄋ丶丶
菍	艹今丶ㄋ
菉	艹录ㄋ一丶
蓇	艹骨丨ㄋ一
蓏	艹瓜ノノ
茝	艹一丨一一
荄	艹亥丶一丶丶
苧	艹宀一丨
糵	艹丶一丶丶
菂	艹白ノㄋ丶丶
藠	艹白ノ丨一一
蓂	劳日丶一丶丶
藦	艹麻ノ一丨
葖	艹穴一ノ
蒟	艹立ノㄋ一一
蔊	艹火丨ㄋ丨
蒻	艹弓丶
蘘	艹襄丶一
萚	艹扌ㄋ丶丨
藨	艹鹿丶丶
芼	艹毛ノ一
荙	艹大丶ㄋ
莙	艹尹丨ㄋ
薁	艹向丶ノ
藟	艹田丨ㄋ一一
茓	艹穴丶丶
鬘	髟日丨ㄋ丶
髽	髟从一丨
髢	髟也ㄋ丨
鬒	髟直ノ丶丶
黡	厂犬丨ㄋ
辁	车人一一
轷	车乎ノ丶丨
辀	车舟ノノ
辌	车京丶一
辒	车日丨ㄋ一
轪	车大一ノ
鸻	彳亍ノㄋ一
衎	彳干一一
衠	彳直ノ丶
徛	彳大一丨丨丨
蟓	虫象ノㄋ
螗	虫广ㄋ一
蜱	虫卑ノ丨
螵	虫覀一一丶丶
螋	虫臼丨ㄋ丶
蠋	虫罒ノㄋ
蟫	虫覀丨ㄋ丨
蝘	虫匚丨ㄋ
蜎	虫口丨ㄋ一
蜐	虫去ㄋノ
螠	虫䒑ノ丶
蚄	虫方丶一
虸	虫子ㄋ丨
亍	亍一一丨
奓	大夕ノㄋ丶
牮	代牛ノ一丨
脩	攸攵ノㄋ一
翛	攸夂ㄋ丶一
伈	亻心丶ㄋ丶
伋	亻及ノㄋ丶丶
侹	亻壬ㄋ丶丶
俵	亻ノㄋ丶丶
倞	亻京丶一丶
傒	亻爫ㄋㄋ
傕	亻冖ノ丨一
僇	亻羽ノ丶ノ
儴	亻襄丶一
鄹	耳又ノ丨
聍	耳宀一丨丨
耵	耳丁一丨丨丨
鬶	夫见一丨
猸	犭丨ㄋ一
猄	犭京丶一丶
猇	犭虍ノㄋㄋ
繄	匚矢ノㄋ丶
匼	匚合ノ丶
邠	分阝ㄋ丨丨
攽	分攵ノ一
絜	丰刀ㄋㄋ
鞬	革聿ㄋ
靸	革及ノㄋ
靰	革兀一ノ
鞡	革扌丶一
靿	革幺ㄋノノ
靺	革末一一丶
鞨	革曷丨ㄋ
鞧	革酋丶
韂	革厃ノ丶一
鹀	工从ノㄋ一
弪	弓轻ㄋ丶一
弶	弓京丶一丶丶
骺	骨一丨一
髃	骨禺丨ㄋ丶
髎	骨羽ノ丶ノ
鄘	广肀ノㄋ丨
鹒	广彐ノ丶一
廆	广鬼ノ丨
魆	鬼戉一ㄋ丶
稃	禾爫ㄋ丨
秾	禾农丶ㄋノ
秬	禾匚ㄋ一
穜	禾立丨ㄋ
穄	禾祭ノㄋ
鹙	禾火ノㄋ
稙	禾直一丨一
穟	禾㒸丶ㄋ
馝	禾日丶ㄋノノ
鹖	曷鸟ノㄋ一
黪	黑叁ノノ
甗	虍鬲一ㄋ
扅	户夕ノㄋ丶
扆	户衣丶一
扊	户炎丶
焜	火日一ㄋㄋ
煴	火日丨ㄋ一一
燏	火矛丨ㄋ一一
爚	火合丨ㄋ
缏	纟亻一丨
纻	纟㝉丶丶
纮	纟ㄋ丶丶丶
缞	纟哀一ノ
绖	纟至一ㄋ
绹	纟勹ノ一
缊	纟日丨ㄋ一一
纴	纟壬ノ一一一
绤	纟谷ノ丶一
缐	纟白丨ㄋ丶
觿	角山ノ丨
觭	角大一丨丨丨
斶	斤罒ノㄋ丶
钸	钅丨ㄋ丨
钶	钅丁丨ㄋ一
钷	钅匚丨ㄋ一
铷	钅女丨
铘	钅牙ㄋ丨
铽	钅弋丶
锎	钅门一一丨
铟	钅因丨ㄋ一一
铌	钅尸ノㄋ
镎	钅合ノ一
铈	钅亠丨ㄋ丨
镱	钅音丶ㄋ
铪	钅合ノ丶一
镨	钅並丨ㄋ一
锘	钅艹一ノ
铹	钅劳ㄋノノノ
铥	钅丿一丨
镤	钅业丶ノ丶
铕	钅丨ㄋ一
钆	钅乚ㄋㄋㄋ
镠	钅羽ノ丶ノ
铚	钅至一ㄋ
铏	钅开丨丨
钘	钅开一一
镴	钅巛丨ㄋ
镈	钅甫一丨丶丶
镚	钅山ノㄋ一
锽	钅白一一一
铻	钅五丨ㄋ
锳	钅艹丨ㄋ丶
钖	钅汤ㄋ
镃	钅䒑ㄋㄋ
锧	钅一丨丶
訄	九言丶一
虓	九虍ノ
鼩	鼠句ノㄋ
鼱	鼠青一一
鼫	鼠石一ノ
吲	口弓丨丨
嚆	口艹丶一一
唛	口ノㄋ
吖	口丷丨丨
鸮	口丂ノㄋ
咥	口至一ㄋ
喤	口白一一一
嗞	口䒑ㄋㄋ
嘡	口一丨一
噇	口立丨ㄋ一一
嚄	口艹ノ丨
慭	夹来一ノ
耇	耂句ノㄋ一
耱	耒麻一ノ一
耠	耒合ノ丶
耥	耒尚丨丶
耢	耒劳ㄋノノ
耖	耒小ノノ
耔	耒子ㄋ
耤	耒昔一丨一一
鸰	令鸟ノㄋ一
詟	龙言丶一
麑	鹿臼ノㄋㄋㄋ
鄜	鹿阝ㄋ丨丨
麀	鹿匕ノㄋㄋ
麖	鹿京丶一丶丶
骎	马彐丶ㄋ
骙	马癸ㄋ丶丶
骃	马因丨ㄋ一
骕	马肀ノ丶丨
骍	马辛丶一丨丨
驲	马日丨ㄋ一
氇	毛鱼丨ㄋ一
毪	毛厶ノ一丨
阇	门者一丨一一
阘	门日ㄋ丶
訚	门言丶一
鄚	莫阝ㄋ丨丨丨
梾	木夹丨ノ
棽	林今ノ丶ㄋ
榃	林田丨ㄋ一
榅	木日丨ㄋ一一
榑	木甫一丨丶
橦	木立丨ㄋ一
檞	木角ㄋノ丨
眊	目毛ノ一ㄋ
睄	目肖丨丶
瞫	目覀丨ㄋ丨
睎	目希ノ丶
戤	乃又丨ㄋ丶丶
鹔	肀八ノ丨
犏	牜户丨ㄋ丨
砮	奴石一ノ一
姤	女丨ㄋ
姽	女厃ㄋㄋ
媖	女艹丨ㄋ
嫪	女羽ノ丶ノ
嫽	女尞一ノ
惎	其心丶ㄋ
氕	气丿ノノ
巯	轻㐬丶一ㄋ
弆	去廾一ノ丨
鸧	仓鸟ノㄋ
颋	壬廴一ノ
颙	禺页一ノ丶
鹍	日比ノㄋ一
旸	日汤ㄋノノ
昡	日亠ㄋ
昫	日句ノㄋ
昽	日龙一ノ
晞	日希ノ丶
曈	日立丨ㄋ一
沲	氵ㄋ丨
漤	氵林ㄋノ
薢	氵角ㄋノ丨
汧	氵开一一
沨	氵风ノㄋ
泂	氵冂丨ㄋ一
泃	氵句ノㄋ
泚	氵此丨一
洈	氵厃ㄋㄋ
湑	氵疋丨ㄋ一一
湜	氵是丨ㄋ丶
滃	氵公ㄋ丶
滆	氵鬲一丨丨
漈	氵祭ノㄋ丶
漻	氵羽ノ丶ノ
潏	氵矛丨ㄋ一一
澥	氵角ㄋノ丨丨
瀌	氵鹿丶丶
瀼	氵襄丶一
翙	山夕ㄋ丶
屼	山兀一ノ
岞	山乍ノ一
崒	山卒丶一丨丨
崚	山土ノ丶
嵎	山禺丨ㄋ丶丶
嵖	山木丨
嶍	山羽ノ丨
嶒	山曾丶
嶓	山番ノ丶一
屃	尸贝丨ㄋ丶
疐	孛田ㄋ丨
饸	饣合ノ丶
饹	饣各ノㄋ一
馉	饣骨丨ㄋ一
饳	饣出ㄋ丨
碥	石户丨ㄋ丨丨
碲	石帝丨ㄋ丨
磉	石又ㄋ丶
礞	石劳一一丶丶
礤	石艹ㄋ丶丶
碶	石丰ㄋノ
磻	石番ノ丶
礌	石雨丨ㄋ一一
矻	石ㄋ
硚	石夭ノ丨
硁	石轻ㄋ丶一一
磡	石其ㄋㄋノ
硙	石山ㄋ一
磹	石覀丨ㄋ丨
硊	石厃ㄋㄋ
碨	石田一ㄋ
磏	石兼丶ノ
砄	石夬ㄋ一丶
矰	矢曾丶ノ一
豨	豕希ノ丶
縠	壳一ㄋㄋ
榖	壳一一丨丶
禚	礻丶丶丶
祎	礻韦一一丨
祏	礻石一ノ
谞	讠疋丨ㄋ一
禛	礻直ノ丶丶
祼	礻日一丨丶
禋	礻覀一丨一
禘	礻帝丨ㄋ丨
祃	礻马ㄋㄋ一
祲	礻彐丶
禤	礻罒ㄋ
祾	礻土ノ丶丶
怊	忄召ㄋノ
忳	忄屯一ㄋ
憭	忄尞一ノ
罽	罒厂丶ノ丨
罶	罒留丨ㄋ
翾	罒同ノㄋ一
撖	扌敢ノ一丶
搋	扌丨一ㄋ
扺	扌氏ノㄋㄋ
扽	扌屯一ㄋ
拃	扌乍ノ一
捽	扌卒丶一
揳	扌丰ㄋノ丶
搒	扌帝丶一
摛	扌㐫丨ㄋ
罍	田田丨ㄋ
鹝	鬲鸟ノㄋ
埘	土日一丨丶
墚	土氵ㄋノ
埯	土大丨ㄋㄋ
塥	土鬲一丨丨
邽	圭阝ㄋ丨丨
赪	赤⺊丨ㄋ丶
玚	王汤ㄋノ
玦	王夬ㄋ一丶
玱	王仓ノ丶ㄋ
珌	王必丶ㄋ丶丶
珪	王圭一丨一一
珰	王ㄋ一
珷	王一一ㄋ一
珺	王尹丨
琭	王录ㄋ一
瑢	王宀ノ丶
瑨	王亚丨ㄋ一
瑱	王直ノ丶丶
璆	王羽ノ丶ノノ
圊	囗青一一一
囝	囗子ㄋ丨
圌	囗山一ノ
韨	韦ㄋ丶
釐	未攵一ノ一
鹯	亠回丨ㄋ一
赟	文一一ㄋ丶
郚	五口ㄋ丨
敔	五口ノ
觱	咸角ノㄋ丨
歅	覀土ノㄋ丶
迺	西辶丶ㄋ丶丶
邲	必阝ㄋ丨丨
嚚	吅臣丨ㄋ一
窊	穴瓜ノノ丶
窅	穴目丨ㄋ
窎	穴鸟ノㄋ
彟	彐寸一丨丶丶
讱	讠刀丶丶
诇	讠冂丨ㄋ一
郪	妻女ㄋ丨
邘	于阝ㄋ丨丨丨
袪	衤去一丨丶丶
袆	衤韦一一丨丨
裈	衤冖一ㄋ
襕	衤门一丨丶丶
褯	衤广一丨
袗	衤㐱ノ丶ノノ
襜	衤厃ノ丶一
褕	衤俞ノ丶
袯	衤发ㄋノ
厾	乙去一丨丶丶
瓻	希瓦一ㄋ丶
醌	酉日一ㄋ
酏	酉也ㄋ丨
醨	酉㐫丨ㄋ丶
酦	酉发ㄋノ
鳓	鱼革ㄋノ
鲺	鱼ノ丨丶
鲴	鱼囗一丨
鲩	鱼宀一一ㄋ
鲕	鱼而一ノ
鳡	鱼咸丶ㄋ丶
鲌	鱼白ノ丨
鳑	鱼帝丶一ノ
鲏	鱼皮ㄋノ丶
鳈	鱼白丨ㄋ丶
鲉	鱼由丨ㄋ
鳀	鱼是丨ㄋ丶
鲙	鱼人一一丶丶
鳁	鱼日丨ㄋ一一
鳉	鱼丬ノㄋ
鳤	鱼丶丶
鲊	鱼乍ノ一一
鱾	鱼己ㄋ一
鲯	鱼其一丨丶丶
鲪	鱼尹丨ㄋ一
鲹	鱼叁ノノ
鳣	鱼亠丨ㄋ一
鲗	鱼贝丨丨
鳒	鱼兼丶ノ
鳛	鱼羽ノ丨
鲾	鱼同丨ㄋ一一
鳠	鱼艹ノ丨
鱽	鱼刀ㄋノ
鲬	鱼甬ㄋ丶
鳂	鱼田一ㄋ
鲘	鱼丨ㄋ一
鄃	俞阝ㄋ丨丨
遹	矛冏丶
矞	矛冏丨ㄋ一
翯	羽高丶一
翚	羽冖一ㄋ
霨	雨尸一一
霅	雨言丶一一
鄠	雨亏ㄋ丨
鹴	雨相ノㄋ
腙	月宀一一丶
脶	月呙丨ㄋ丶
膦	月米ノㄋ丨
脎	月乂一丨丶
腽	月日丨ㄋ一一
脒	月米丶
膪	月帝丨ㄋ一一
腘	月囗一一丶
胠	月去一丨丶
臜	月先ノ一丶丶
臑	月雨一ノ丨
螣	月丨ㄋ丶
縢	月ㄋㄋ
肸	月八一丨
腒	月尸一丨一一
胈	月ㄋ丶丶丶
朏	月出ㄋ丨
谿	爫幺一ノ一
疍	疋旦丨
龁	齿ㄋㄋ
舭	舟比一ㄋ
舲	舟令ノ丶丶
鸼	舟鸟ノㄋ一
艎	舟白一一一
艅	舟余ノ丶丶
鼽	自畀ノㄋ
趯	走羽ノ丨
阢	阝一ノㄋㄋ
隩	阝向丶ノ
鹢	䒑八丨ㄋ
盦	今酉丨ㄋ一一
镵	钅丨ㄋ丶
耰	耒丆丨ㄋ丶
襫	衤一一ノ丶
盉	禾皿丨ㄋ一
鲖	鱼冂一丨一一
祊	礻方丶一
鄀	艹丨ㄋ丨丨
矼	石工一丨一
腯	月一丨一一
逴	卓辶丶ㄋ丶
菼	艹炎丶ノ丶丶
鼒	才目ㄋ
簉	告丶
镋	钅ノㄋㄋ
鄅	禹阝ㄋ丨丨
馌	饣去丨ㄋ一一
芣	艹不一ノ丶
辿	山辶丶ㄋ丶
鸤	尸鸟ノㄋ一
糒	米ノノ
靽	革半丶ノ丨
讻	讠乂ㄋ
骦	马雨一丨一
靬	革干一一丨
貆	豸一丨ㄋ一
莝	艹从一丨一
蹢	啇丶一
衃	扌丿丨ㄋ一
羱	厂ノ丨
荁	艹一丨ㄋ一一
褟	衤日ㄋ丶
砆	石夫一一
鄌	广肀丨ㄋ丨
硍	石艮ㄋ一
鞁	革皮ㄋ
礵	石雨一丨一
豮	豕十一丨丶
齇	自畀丨一
萹	艹户丨ㄋ丨
蝲	虫束丨丨
丏	正ㄋㄋ
乸	也母ㄋ
亶	亠回丨ㄋ一一
亸	享单丶
亹	亠冂丨ㄋ一一
伾	亻不一一
佸	亻舌ノ一一
佺	亻人一一一
佽	亻次丶一
侁	亻先ノ一ㄋ
侂	亻广ノ一
侘	亻宀ノ一
侴	人一ㄋ丨
俍	亻良丶ㄋ丶丶
俶	亻上丨ノ
倓	亻炎丶ノ丶
倴	亻大一丨丨丨
倻	亻耳ㄋ丨丨丨
偁	亻爫丨ㄋ一
偓	亻尸一ㄋ一
偭	亻丆丨ㄋ一一
偲	亻田丶ㄋ
傉	亻辰一丨丶丶
僰	朿朿ノ丶
冏	冏丨ㄋ一
冮	冫工一丨一一
凓	冫覀一丨丶
凘	冫其ノノ丨
刬	戋刂丨丨丨
剅	豆刂丨丨
剋	古儿丨丨
剕	非刂丨丨
剟	双双丨丨
劄	合丨丨
劼	吉力ㄋノノ
勔	丆囬ㄋノノ
勚	世贝ㄋ
匜	匚也ㄋ丨ㄋ
卬	卩ㄋ丨
叆	云受一ノ丶
叇	云隶丶ㄋ
吽	口牛ノ一丨丨
咍	口台ㄋ丶
咡	口耳一丨一
哢	口王一ノ
哱	口十丶ㄋ一
唝	口工丨ㄋ丶丶
唵	口大丨ㄋㄋ
啰	口罒ノㄋ丶
啴	口单丶ノ
嗐	口宀一一一
嘚	口彳丨ㄋ丶丶
噀	口巳ㄋ一丶
嚭	壴口一ノ
囷	囗禾ノ一
圐	囗罒丶一ノ
圙	囗八一ノ一
圫	乇ノ一
坬	瓜ノノ
垍	自ノ丨
垚	土一丨一
垞	宀ノ一
垟	羊丶ノ丨丨
垾	日一一丨
垿	广ㄋ丶丨
埌	良丶ㄋ
埗	止丨ノ
埫	尚丨丶一
埵	垂ノ一
堃	方方一丨一一
堉	丨ㄋ一
堌	囗一丨一
堧	土而一ノ丶
堽	罒一丨一
堾	丨ㄋ一
塅	段ノ
塆	亦ㄋ一
墐	堇一丨
墕	正一ㄋ丶
墘	一ノ
墡	羊丶ノ一
壸	壳亚一
夐	𠔿丨ㄋ丶
夬	夬ㄋ一
奡	丆目一ノ
奭	大百一ノ
妘	女云一一
姞	女吉一丨
姮	女一丨ㄋ一
姱	女大一一ㄋ
娀	女戈一ノ
婞	女土丶
婳	女一丨ㄋ丨
婼	女艹一ノ
媭	彡页ㄋノ
嫄	女厂ノ
嫕	女匚ノ一
嫚	女日丨ㄋ丶
嬿	女廿丨ㄋ丶丶
孖	子子ㄋ丨
宬	宀戊ㄋㄋ
尨	尢彡丶
屾	山山丨ㄋ丨丨
峂	山夂丶丶
峃	学山丨ㄋ丨丨
峛	山歹丨丨丨
峣	山尧一ㄋㄋ
峧	山交丶一
峱	犭丑丨ㄋ丨
崀	山良丶ㄋ
崁	山土ノㄋ
崄	巾佥ノ丶一
崟	山金ノ丶一
崿	山吅一一ㄋ
嵚	山钅ノㄋ
嵲	山自一丨丶
嶅	敖山丨ㄋ丨丨
嶲	山隹丨
巉	山丨ㄋ丶丶
帨	巾总ノㄋㄋ
幖	巾覀一一丶丶
幪	巾劳一一丶
庤	广土一丨
庼	广一
廋	广臼丨ㄋ丶
廙	广田一
弨	弓召ㄋノ
彧	弋口一ノ
忞	文心丶ㄋ丶
忺	忄欠ノㄋ丶
恓	忄西一丨一
悢	忄良丶
惇	忄享丶一一
惙	忄双ㄋ
惛	忄氏丨ㄋ
愐	忄丆丨ㄋ一
愔	忄音丶
慥	忄告丶ㄋ
憙	壴口丶ㄋ
扞	扌干一一
抃	扌丶一丨丶
抔	扌不一ノ丶
拤	扌上丨丶
挓	扌宀ノ一
挦	扌彐一丨丶丶
捯	扌至丨丨
掞	扌炎丶ノ
揕	扌其ㄋㄋㄋ
摽	扌覀一一丶丶
擿	扌商丶ㄋ
斝	吅冖丶丶丨
斠	冓⺀一丨丨
旐	方ノㄋ
旻	日文丶一丶丶
昄	日ㄋ丶丶
昉	日方丶
昪	日厶一ノ
昳	日丿一一丶
昺	日丙ノ丶
晅	日一丨ㄋ一
晢	折日丨ㄋ一一
暅	日忄一丨
暕	日柬一丨
暵	日廿丨ㄋ丶
曌	日月丶丶
朓	月儿丶一
朳	木八ノ丶
杕	木大一ノ丶丶
杙	木弋一ㄋ
杧	木亡丶一ㄋ
杻	木丑ㄋ
枲	台木一丨
枹	木勹ㄋ一
柈	木半丶ノ
柊	木夂丶丶丶
柷	木口ノㄋㄋ
栒	木勹丨ㄋ一一
栟	木䒑一ノ丨
栴	木ノㄋ
栻	木弋一丨一
桯	木口一一一
桲	木十丶ㄋ一
桹	木良丶ㄋ
梣	木山ノ丶ㄋ
梼	木一丨丶
梽	木士丶ㄋ
梿	木车丶ㄋ丶
棁	木总ノㄋㄋㄋ
棐	非木一丨
棓	木立丨ㄋ一一
棨	户攵一丨丶
棪	木炎丶ノ丶
棫	木戈丨ㄋ
棬	木ㄋㄋ
棻	艹分一
椑	木卑ノ丨丨
椓	木豕丶丶
椪	木並丶ノ
椸	木族ㄋ丨
楒	木田丶ㄋ丶
楯	木一丨一一
榰	木耂ノㄋ一
槃	舟殳一丨丶
槚	木覀丨ㄋ丶
槜	木隹ㄋ
槱	木酉丶丶丶
櫆	木鬼丶丶丨
欂	木落一丨丶丶
欸	厶矢ノㄋ
欻	炎欠ノㄋ
殣	歹堇一丨一
毌	毌ㄋㄋ一
毐	士毋ㄋㄋ一
氾	氵㔾ㄋㄋ
氿	氵九ノㄋㄋㄋ
汈	氵一一
汫	氵井一一
汭	氵内丨ㄋ
沄	氵云一一丶
沘	氵比一ㄋㄋ
沚	氵止丨一一
沺	氵田丨ㄋ一
泇	氵加ㄋノ一
泜	氵氏丶丶丶
洑	氵亻一ノ
洢	氵亻ㄋ一
洣	氵米丶ノ丶
洨	氵交丶一丶
洭	氵匚一一一
洸	氵光丨丶
洺	氵夕丨ㄋ一一
洿	氵大一一ㄋ
浉	氵一丨
浐	氵产丶一ノ
浕	氵尺丶丶
浛	氵今丨ㄋ一一
浡	氵十丶ㄋ
浥	氵口ㄋ丨ㄋ
浬	氵里丨ㄋ一
浭	氵更一丨丶丶
浰	氵禾丨丨
浲	氵夂一一
涐	氵我ノ一丶丶
涘	氵厶ノ一
涢	氵口丨ㄋ丶丶
涴	氵宀ノㄋㄋ
淏	氵日一一丶丶
淟	氵曲ノ丶丶
淯	氵丨ㄋ一一
淴	氵勿丶ㄋ
渟	氵亮一ノ丶
渼	氵一ノ
湉	氵忄ノ一一
湝	氵比ノ丨
湣	氵民丨ㄋ一一
湲	氵爰ノ丶丶
湴	氵並丶ノ一
溁	氵劳一丨丶丶
溇	氵米ㄋノ一
溚	氵艹ノ丶一
溠	氵一丨一一
溦	氵山一ノ丶
溵	氵ㄋ一丶
滉	氵日丨丶
滍	氵蚩ㄋ丨
滘	氵冖ノ丶一
滪	氵予一ノ
滫	氵攸ノ一
漋	氵阝ノㄋ一一
漖	氵耂ㄋ丨
漦	未攵一ノ丶
漷	氵享ㄋ丨丨
漼	氵山ノ丨
潖	氵王一一ㄋ
潟	氵臼ノㄋ
潩	氵田一
潵	氵丨ㄋ丶
潽	氵並丨ㄋ一一
潾	氵米ノㄋ
澽	氵虍一ノ丶
瀍	氵广丨ㄋ一一
瀔	氵壳一ノ
炆	火文丶一丶
炘	火斤ノノ丨
炟	火旦丨ㄋ一
烔	火冂一丨一
烜	火一丨ㄋ一一
烝	丞灬丶丶
烺	火良丶ㄋ丶
焌	火夋ㄋ丶丶
焗	火尸ㄋ丨
熛	火覀一一丶
熜	火囟ノㄋ丶
熥	火甬丶ㄋ
燊	火火丶ノ丶
燚	炎炎丶ノ丶
爇	艹土ノ丶丶
爔	火ノ一
牁	爿可一
牂	爿羊丶ノ丨
牚	牙一ㄋ
牤	牜亡丶一
牻	牜尢ノノ
犇	牛牛ノ一丨
犨	隹隹ノ一丨
狉	犭不一
狝	犭尔ノㄋ丶
猺	犭爫ノ一丨
獴	犭劳一一丶丶
玕	王干一一
玘	王己ㄋ一
玙	王与一一
玞	王夫一一
玠	王人ノ丨丨丨
玡	王牙一ㄋノ
玥	王月ノㄋ一
珅	王日丨丨
珖	王光丨丶
珣	王勹丨ㄋ一
珽	王丿丨一
琀	王今丨ㄋ一
琇	王禾ㄋノノ
琎	王井丶ㄋ
琤	王争ノㄋ丨
琫	王一一丨
琯	王宀丨ㄋ一
瑀	王禹ノ丨丶
瑄	王㝉丨ㄋ一一
瑑	王彖ㄋㄋ
璈	王敖一一丶
璘	王米ノㄋ丨
璟	王日丶一
璪	王口丨ㄋ丶
瓖	王襄丶一丶
瓘	王艹丨ㄋ一一
甡	生生ノ一一
甪	丿用ノㄋ
畖	田瓜ノノ丶
畤	田土一丨丶丶
畯	田夋ㄋ
疢	疒火丶ノ丶丶
疭	疒从ノ丶丶
癗	疒雨丨ㄋ
皕	百百一ノ一
皞	白白一ノ
皦	白白丶一
皭	白爫丨ㄋ丶
砵	石木一一
膙	月弓丨ㄋ丶丶
薸	落覀一一丶
觃	见子ㄋ丨
馞	禾日一丨一
骉	马马ㄋㄋ一一
鹲	劳一一ノ
齉	自畀一丨
矇	目艹一丨
慓	忄覀一一
揾	扌日丨ㄋ一一
檵	木幺ㄋㄋ
屌	尸口丨ㄋ丨丨
蹓	留丨ㄋ一一
歔	虍业ノㄋ丶
砢	石可一丨
娭	女厶ノ
彿	彳弓ノ丨丨
冇	冂丨ㄋㄋ
袴	衤大一一ㄋㄋ
毑	母也ㄋ丨
濛	氵劳一一丶丶
觍	曲八丨ㄋ
沢	氵尺ㄋ一丶
飔	风田丶ㄋ
裛	亠口ノㄋ丶
悆	余心丶ㄋ丶丶
垎	各ノㄋ一
墣	业丶ノ
䣘	土ㄋ丨丨
䢼	共阝ㄋ丨丨丨
籥	合丨ㄋ丨
箖	林一丨丶
筶	告ノ一
羕	永丶ㄋ
跱	土一丨丶
谼	谷共一丨丶丶
鄫	曾阝ㄋ丨丨
䎖	曾羽ㄋ丶一
痓	疒至一ㄋ
蒐	艹鬼ノ丨丶丶
蒨	荷青一一一一
葰	荷夋ㄋ丶丶
葴	艹咸一
蕗	艹ノㄋ
薳	艹吉ノㄋ丶
芃	艹凡ノㄋ丶丶
莿	艹朿丨丨丨
荖	艹耂ノㄋㄋ
茽	荷中丨ㄋ丨
蒄	劳元一丨丶
芠	艹文丶一
䓨	劳缶ノ
䓫	艹大一丨丨
軎	車口丨ㄋ一
衒	彳亠ㄋㄋ
蚵	虫丁丨ㄋ
虷	虫干一一
伣	亻见丨ㄋㄋ
伭	亻亠ㄋㄋ
佖	亻必丶ㄋ丶丶
俙	亻希ノ丶丨
俫	亻夹丨ノ
偰	亻丰ㄋノ丶
儦	亻鹿丶丶
狨	犭戈一ノ
㺄	犭俞ノ丶丨
猯	犭山一ノ丨
猰	犭丰ㄋノ丶
旞	族㒸丶ㄋ
鞮	革是丨ㄋ
廾	廾一ノ丨
庱	广土ノ丶丶
魋	鬼隹ノ丨
馧	禾日丨ㄋ一
稌	禾余ノ丶丶
穙	禾业丶ノ
稑	禾土ノ丶
䅟	禾叁ノ
虍	虍丨一
虤	虍几丨一
扂	户占丨一
烶	火壬ㄋ丶
焆	火口丨ㄋ一一
煓	火山一ノ丨
熇	火高丶一
彐	彐ㄋ一一
翈	甲羽ㄋ丶
䌹	纟冂丨ㄋ一一
觟	角圭一丨一一
镮	钅同ノㄋ丶
䥽	钅发ㄋノ
咇	口心ノノノ
啫	口者一丨一一
竘	立句ノㄋ一一
䶮	龙天一一丶
粿	米日一丨丶丶
糸	糸ㄋㄋ
麴	十人ノ丶
㭕	木去一丨丶
枅	木开一一
梌	木余ノ丶
梠	木口丨ㄋ一一
棤	木昔一丨一一
椆	木冂一丨一
楙	木矛一丨丶丶
橑	木尞一ノ丶
㛚	女甬ㄋ丶丨
妭	女ㄋ
姶	女合ノ丶一
婍	女大一丨丨
婤	女冂一丨一
婫	女日一ㄋ
媂	女帝丨ㄋ丨丨
媓	女白一一
媞	女是丨ㄋ
嬥	女羽ノ丨
嬬	女雨一ノ
隺	冖隹ノ丨
凵	凵ㄋ丨
䢺	出阝ㄋ丨丨
䴖	青鸟ノㄋ一一
旴	日于一一
昈	日户丶ㄋ
昣	日㐱ノ丶ノ
晊	日至一ㄋ一
晐	日亥丶一丶
溍	氵亚丨ㄋ一一
濩	氵艹ノ丨丶
酅	山隹丨ㄋ
岠	山匚ㄋ一一
峗	山厃ㄋㄋ
峿	山五丨ㄋ一
崌	山尸一丨
嵅	山咸一ノ
嶦	山厃ノ丶一一
螱	尸示一丨丶丶
饻	饣衣丶
磜	石祭ノㄋ
碃	石青一
砫	石主丶一一
碏	石昔一丨一
硔	石共一丨丶丶
祋	礻殳ノㄋ丶
禔	礻日丨ㄋ一一
㥄	忄土ノ丶
憺	忄厃ノ丶一
疁	田羽ノ丶ノ
鬷	鬲㐅ㄋ丨
邿	土寸ㄋ丨
玹	王亠ㄋㄋ丶
玼	王此丨一ㄋ
珸	王五丨ㄋ一一
琄	王口丨ㄋ一一
瑂	王丨ㄋ
瑅	王是丨ㄋ丶
瑔	王白丨ㄋ丶
瑝	王白一一一一
璠	王番ノ丶
璮	王亠丨ㄋ一一
璲	王㒸丶ㄋ
瓀	王雨一ノ丨
囗	囗丨ㄋ
诐	讠皮ㄋノ
鄑	亚日ㄋ丨
襚	衤㒸丶
尢	尢一ノ
酺	酉甫一丨丶丶
鳋	鱼又丶丨
鲿	鱼丶ㄋ丶丶
翀	羽中丨ㄋ
翂	羽分ノ丶
勠	羽㐱ㄋノ
腨	月山一ノ丨
脟	月爫一丨丶丶
脿	月ノㄋ
龂	齿斤ㄋ丨
舠	舟刀ㄋ
舥	舟巴ㄋ丨
齄	自畀一丨一
隃	阝俞ノ丶
陞	阝丿一ノ
蒱	艹扌一丨
纼	纟弓丨丨丨
筤	良丶ㄋ
耏	而彡ノノ
荓	艹䒑一ノ丨
羓	巴ㄋ丨
硿	石穴一丨一
竫	立争ノㄋ
笯	女ㄋ丶
蟏	虫艹ㄋ一
砠	石且丨ㄋ一
蔈	艹覀一一丶
蚆	虫巴ㄋ
碈	石氏丨ㄋ一
陑	阝而一ノ
盷	目勹丶一一
禒	礻彖ㄋㄋ丶
翷	米舛ㄋ丶一一
胣	月ㄋ丨
鞳	革艹ノ丶
蓢	艹朗ノㄋ一一
㑇	亻刍ノㄋ
㑊	亻亦丶一丶丶
㕮	口父ノ丶丶
㘎	口门ㄋ一丶
㙍	土双ㄋ丶
㙘	土覀ㄋノ
㙦	余⺀一丨一
㛃	丰刀ㄋノ
㛹	女亻一丨
㟃	山丨ㄋ一一
㠇	山京一ノ丶
㠓	山劳一一丶丶
㤘	忄刍ノㄋ一
㧐	扌双ㄋ丶丶丶
㧑	扌为丶ノ丶
㧟	扌氵一ㄋ
㫰	日良丶ㄋ丶
㬊	日爰ノ丶丶
㬎	日ㄋㄋ
㬚	日丨ㄋ丶
㭎	木冈丨ㄋ丶
㮾	朗月一
㰀	木禾ノㄋ
㳇	氵父ノ丶丶
㳘	氵ノㄋㄋㄋ
㳚	氵戊丶丶丶丶
㴔	氵刍丶ㄋ丶
㵐	水厂丶ノ丶丶
㶲	火用ノㄋ丨
㸆	火告丨一一
㸌	火雨ノ丨
㻬	王雨一一ㄋ
㽏	氵合一丨一
㿠	白光丨丶
䁖	目米ㄋノ
䂮	丰刀一ノ一
䃅	石单丶
䃎	石大ノ
䎃	冉羽ㄋ丶一
䏝	月专一一丶丶
䏡	月示一一丶丶
䏲	月弟丶ノノ
䐃	月囗ノ一丶
䓖	艹穴ㄋノノ
䓛	艹尸ㄋ丨
䓬	艹卓丨一
䕫	艹白丨一丶丶
䗖	虫带一丨丨
䗛	虫亻丨ノ
䗪	度灬丨ㄋ
䗴	虫ノ一
䜣	讠斤ノノ
䝙	豸区一ノ
䦃	钅艹一丨一
䲟	鱼ㄋ丨
䲠	鱼丨ㄋ一一
䲢	月ノㄋ一一
䴓	一巾ノㄋ
䴔	交鸟ノㄋ一一
䴕	歹刂ノㄋ
䴗	日犬ノㄋ一一
䴘	虍ノㄋ一
䴙	辟鸟ノㄋ一一
佁	亻台ㄋ丶一
倕	亻垂ノ一一
倧	亻宀一一丶丶
偡	亻其ㄋㄋ
傃	亻ㄋㄋ
僎	亻巳ㄋ一丶
僔	亻酋一丨丶
儳	亻丨ㄋ
冔	日口一一丨
厖	厂尢ノノ
叕	双双ㄋ丶
叚	叚ㄋ一丶
呇	水口丨ㄋ一一
呣	口母ㄋㄋ
咉	口央丨ㄋ丶
咺	口一丨ㄋ一一
哃	口冂一丨一
喆	吉吉一丨一一
噂	口酋一丨丶丶
圢	丁一丨丨
圲	千ノ一
坒	比土一丨一一
坥	且丨ㄋ一一
坽	令ノ丶
垈	代土一丨
垏	聿ㄋ一丨
垙	光丨丶ㄋ
垵	宀ㄋノ
垺	爫ㄋ丨
埪	穴一丨
堐	厂一丨一一
堲	卩一丨一
堼	圭寸一丨一
塱	朗月一丨
妧	女元一一
姈	女令ノ丶丶
娵	女耳ㄋ丶
婌	女上丨
婘	女ㄋㄋ
婠	女宀丨ㄋ一
婻	女十丨ㄋ丨
媄	女一ノ
媆	女而一ノ
媱	女爫ノ一丨
嫭	女虍ノ丶
孅	女从一ㄋ
寁	宀妻丨一
尪	尢王一一一
岊	巴山丨ㄋ
岨	山且丨ㄋ一
峏	山而一ノ丨
峘	山一丨ㄋ一一
崡	山了丶
崶	山圭一丨丶
嵁	山其ㄋㄋㄋ
嶟	山酋一丨丶
帡	巾䒑一ノ
弢	弓山ㄋ丶
弸	弓月ノㄋ一一
恔	忄交丶一丶
悈	忄戈一
悰	忄宀一一
惔	忄炎丶ノ
愃	忄㝉丨
愭	忄耂ノㄋ
慆	忄爫ノ丨
慬	忄堇一丨
憕	忄登ㄋ丶
戭	㝉由ノ丶丶
摏	扌ノ丨
摴	扌雨一一
敩	学子ノ一
旵	日山丨ㄋ丨
旿	日一丨丨
昇	日丿一ノ
昒	日勿ノㄋ
昤	日令ノ丶
晙	日夋ㄋ丶
晪	日曲ノ丶丶
晫	日卓丨一
晱	日炎丶ノ丶
暲	日音一丨丨
暶	日族ㄋ丨
暿	日壴丨ㄋ一一
朸	木力ㄋノ
杄	木千ノ一丨
枍	木八一ㄋ
柖	木召ㄋノ一
栐	木永丶ㄋ
梴	木丿丨一
椀	木宀ノㄋㄋㄋ
楩	木亻一丨
楪	木世一
橞	木惠丶ㄋ丶
汋	氵勹丶丶
沇	氵厶ノㄋㄋㄋ
泙	氵平一丶
洓	氵朿一丨丶丶
洘	氵耂一ㄋㄋㄋ
洴	氵䒑一ノ丨
浟	氵攸ノ一丶
涄	氵由一ㄋㄋ
涍	氵耂ㄋ丨一
淜	氵月ノㄋ一
渰	氵合一ノ丨
溞	氵又丶丨
溹	氵孛ㄋㄋ
滧	氵交ノ一丶
漴	氵山丶
漹	氵正一ㄋ
澂	氵山一ノ丶丶
澛	氵鱼丨ㄋ一一
澪	氵雨ノ丶丶丶
澭	氵亠ㄋㄋ一
澼	氵辟ㄋ一
濋	氵林ㄋ丨丶
瀱	氵罒一ノ
灈	氵目丨ㄋ一一
炌	火人ノ丨
炣	火可一丨丨
烠	火丨ㄋ一一
烻	火丿丨一
焞	火享丶一一
煁	火其ㄋㄋㄋ
煃	火大一丨一一
煋	火日ノ一
煟	火田ノㄋ
熻	火合ㄋ丶一
燋	火隹丶丶丶丶
爟	火艹丨ㄋ
牥	牜方丶一ノ
玃	犭目丨ㄋ丶
玒	王工一丨一一
玓	王勹丶丶丶
玤	王丰一一丨丨
玭	王比一ㄋㄋ
玶	王平一丶
玿	王召ㄋノ一
珇	王且丨ㄋ一一
珋	王卯ㄋ丨
珒	王聿ㄋ一
珕	王力ㄋノノ
珛	王丨ㄋ一一
珝	王羽ㄋ丶一
珢	王艮ㄋ一丶
珦	王向丨ㄋ
珫	王ノㄋㄋㄋ
珵	王口一一一
珹	王戊ㄋㄋ
琈	王爫ㄋ丨一
琔	王定丶丶丶丶
琟	王隹ノ丨
琡	王上丨ノ丶
琲	王非丨一一
瑃	王丨ㄋ
瑆	王日ノ一
瑓	王柬一丨
瑖	王段ノ丨
瑧	王ノ一
瑬	氵㐬一一丶丶
瑳	王一丨一一
璒	王登ㄋ丶
璥	王艹ノㄋ丶丶
璬	王白丶一
璱	王王一一丶
甦	更生ノ一一
癿	白乙ㄋㄋ
皛	白白ノ丨
苉	艹匚ノㄋㄋㄋ
茋	艹氏丶丶丶
萣	艹定丶丶
萳	艹十丨ㄋ丨
蔃	艹弓丨
蚲	虫平一丶
蛃	虫丙ノ丶
陎	阝丿一一丶
囧	冏一一一一
琍	王禾丨丨丨丨
枒	木牙一ㄋノ
蠧	壳石丨
俬	亻禾ㄋ丶
粬	米曲丨ㄋ一
誌	言士丶ㄋ
頔	由丆丨ㄋ丶丶
嘢	口里ㄋ丶
傢	亻宀一ノ丶丶
碁	其石一ノ一
嬅	女艹一丨
乂	乂ノ丶丶
𬉼	火区一ノㄋ
𠳐	口ㄋ丨丨
𥻗	米木丨ㄋ一一
齁	自畀ノㄋ一
彳	彳ノノ
𠙶	了凵ㄋ丨丨
𬣙	讠于一一丨
𨙸	十又ㄋ丨
𬇕	氵万一ㄋ
𬣞	讠㝉丶丶
𬘓	纟川ノ丨
𫭟	区一ノㄋ
𫭢	人ノㄋㄋ
𫇭	艹为丶ノ丶丶
𫐄	车兀一ノㄋ
𫵷	山厂一ㄋノ
𣲘	氵一一ノ
𣲗	氵韦一一丨丨
𬇙	氵贝丨ㄋ丶丶
𬣡	讠戋一一
𫸩	弓区一ノㄋ
𨚕	厶廾ㄋ
𫘜	马文丶一
𬘘	纟冖ノㄋ
𫘝	马夬ㄋ一
𦭜	艹口ノ丶
𬨂	车氏ノㄋㄋ
𬀩	日韦一一丨丨
𬀪	日见丨ㄋㄋ
𬬩	钅弋一ㄋ
𫍣	讠冂一丨一一
𬣳	讠艮ㄋ一
𬩽	彐寸ㄋ丨丨
𬮿	阝己ノㄋㄋ
𬯀	阝文ノ丨
𫰛	女轻ㄋ丶一
𬳵	马不一一一
𬳶	马冂丨ㄋ一
𫠊	马玄丶一丶
𬍛	王丨ノ
鿍	夂一ㄋ丨
𬜬	艹门丨ㄋ一一
𦰡	艹ㄋ丨丨丨
𪾢	目见丨ㄋ
耑	山而一ノ丨丨
𪨰	山曲丨
𫓧	钅夫一一
𬬮	钅长ノ一丶
𬬱	钅斤ノノ
𬬭	钅人ノㄋ
𦙶	月古一丨一
𬘡	纟因丨ㄋ
𬳽	马先ノ一ㄋ
𬘩	纟丿丨一丶
𪟝	贝ㄋノ
𬍤	王彐一丨丶
𫭼	劳ㄋノノ
𬜯	艹丙ノ丶丶丶
𬂩	木夹ノ丶丶
𫠆	十又一ノ
𨐈	车光丨
𬌗	牙合ノ丶一
𫑡	口日ㄋㄋ丨
𪨶	山大一ㄋ丨
𬬸	钅木丶
𬬻	钅⺊ㄋ一
𬬹	钅日丨丨
𬬿	钅召ㄋノ一
𬭁	钅母ㄋㄋ丶
𫢸	亻单丶ノ
𫗧	饣束一丨丶
𬊈	火彐一丨丶
𬒈	学石一ノ一一
𨺙	阝臼ノㄋㄋ
𬳿	马余ノ丶丶
𫄨	纟希ノ丶
𬘫	纟宀一一ㄋ
𫮃	单丶
鿎	石大丶ㄋ丶
𬱖	由页一ノ丶丶
𬟽	虫东一ㄋ
𫓯	钅圭一丨
𫟹	钅共一丨丶
𫟼	钅大丶ㄋ
𠅤	亠田丶ㄋ丶
𬇹	氵囗一一丶
𬍡	氵汤一一一
𬤇	讠覀一丨一
𫍯	讠咸一ノ丶
𬤊	讠是丨ㄋ丶
𫍲	讠臼丨ㄋ
𬯎	阝贵丨ㄋ
𬘬	纟青一一
𬘭	纟林一丨丶
𬴂	马非丨一
𫘦	马勹ノ一
𫟅	纟京丶一
𬘯	纟享丶一一
𫘧	马录ㄋ一
𪣻	米ㄋノ
𡎚	户丨ㄋ丨
𬃊	木一丨丶丶
𬷕	甫鸟ノㄋ一
𫐐	车臼ノㄋ
𬹼	齿人ノ丨丨
𧿹	母ㄋㄋ丶
𫶇	山带一丨
𫖮	山己一ノ
鿏	钅ノㄋ丶
𬭊	钅木一丨一
𨱇	钅求一丨丶
𫓶	钅口丨ㄋ一一
𬭎	钅宀一ノ丶
𫖯	儿一ノ丶
𬱟	厃㔾一ノ
𫛭	犭王ノㄋ一
𫷷	广钅ノㄋ丶
𬮱	门覀一丨一
𬊤	火单丶ノ
𣸣	氵十一丨丶丶
𬴃	马丰一ノ一
𫘨	马是丨ㄋ丶丶
𤧛	王帝丨ㄋ丨
𬪩	酉农丶ㄋノノ
𬒔	石止丨ㄋ一
𬨎	车酋丶ノ一
𫐓	车矛一
𫫇	口亚丶
𫓹	钅其一丨丶
𬭚	钅享丶一一一
𬭛	钅氵ㄋノ丶
𬕂	工丨ㄋ丶丶
𬶋	鱼句ノㄋ一
𬶍	鱼宀ノㄋㄋㄋ
𦝼	月米ㄋ
𫔶	门自一丨丶
𫌀	礻丨ㄋ丶丶
𫖳	尹口一ノ丶
𫘪	马厂ノ丨
𫘬	马爫ㄋㄋ丶
𫞩	王艹一丨
𡐓	广ㄋ一丶
𪤗	羽ノ丶
𣗋	ノㄋ
𬸘	匚日ㄋノ一
𬒗	石监丨ㄋㄋ
𥔲	石吅一一
𫚖	此鱼ノㄋ一
𨱏	钅艹ノ丶
𬭤	钅亻ノ丨
𫚕	鱼一丨
𬶐	鱼儿丶一丶
𬶏	鱼厃ㄋㄋㄋ
𩽾	鱼宀ㄋノ
𬸚	犭讠一ノ一
𬤝	讠惠丶ㄋ
𬙂	纟㝉丨ㄋ丶
𬭩	钅公ㄋ丶
𩾃	鱼免ノㄋ
𬸣	寒鸟ノㄋ一一
𫍽	讠罒丨ㄋ丶
𬴊	马米ノㄋ丨
𬞟	艹止丨ノ
𥕢	石曹一丨
𫟦	车㒸丶ㄋ丶
𬺈	齿大一丨丨丨
𫠜	齿臼ノㄋㄋ
𪩘	山十丨ㄋ丨
𬭬	钅丰一一一一
𨱑	钅丨ㄋ丶
𬭯	钅敝丶ノ
𫗴	饣亠丨ㄋ
𬸦	族疋ノㄋ一
𫄷	纟音丶
𤩽	王十丨ㄋ丨
𬭳	钅壴丨ㄋ一一
𬭶	钅黑丨ㄋ丶
𫔍	钅番ノ丶
𬭸	钅米ノㄋ丨
𨱔	钅酋一丨丶丶
𬭼	钅㒸丶ㄋ
𫔎	钅矛丨ㄋ一
𬸪	番鸟ノㄋ
𬶟	鱼束丨丨
𬶠	鱼柬一丨
𬶨	旡ノㄋ
𦈡	纟雨一ノ丨
𫄸	纟千丨ㄋ丶
𬟁	艹鬲ノㄋ
𥖨	石口丨ㄋ丶丶
𦒍	立里ㄋ丶一
𬙊	纟黑一丨一一
𬶭	鱼祭ノㄋ
𩾌	鱼广ㄋ一丶
𨟠	目目ノ丨丨
𬶮	鱼壴丨
𨭉	文一一ㄋ一
𬙋	纟襄丶一丶
𤫉	王火丶一丶丶
𬺓	齿林ㄋ丨
𫚭	鱼巛丨ㄋㄋ