易	日勿⼃
黄	龷由
复	𠂉日⼃
送	䒑大⼂
团	囗才⼀
句	勹口⼁
官	宀㠯⼁
敢	乛耳⼃
修	夂
照	日刀
丽	丽⼀
备	夂田⼁
急	刍心⼂
忙	忄亡
母	母⺂
欢	又欠⼃
英	艹冂⼀
古	古⼀⼁
底	广氏⼂
巴	巴⺂⼁
帮	阝
终	纟夂⼂
势	执力
娘	女丶
热	执灬⼂
显	日业⼁
朝	𠦝月⼃
错	钅龷
持	扌土⼀⼁
调	讠冂
宝	宀王⼂
香	禾日⼁
低	亻氏
丝	
曾	曾⼂⼃
冲	冫中⼁
线	纟戋⼀
级	纟及
示	示⼀⼀
改	己攵⼃
待	彳土⼀⼁
包	勹巳⺂
台	厶口⼁
沉	氵冖⼃
愿	厂白⼁
久	久⼃⺂
希	乂𠂇⼁
木	木⼀⼁⼃
响	口⼁
破	石皮
首	䒑自⼃
模	木莫⼀
脚	月去⺂⼁
害	宀丰⼁
约	纟勹⼂
资	次贝⼁
穿	穴牙
联	耳䒑
哈	口合
树	木又
雪	⻗彐⺂
楚	林疋
注	氵主
引	弓丨⼁
护	扌户
另	口力⺂
故	古攵⼃
村	木寸⼀
存	子⺂
嘴	口此⼃
依	亻衣⼂
诉	讠斤
造	告辶⼂
技	扌十
露	⻗⻊
除	阝亼
慢	忄日⼁
具	八
摇	扌爫
观	又见⼁
楼	木米
商	冂⼃
型	开刂⼀
府	广亻⼀
停	亻⼀
爷	父卩⺂
铁	钅丿⼀
段	段⼃⼁
广	广⼂⼀
念	今心⼂
组	纟且⼁
节	艹卩⺂
需	⻗而
议	讠义⼂
举	八⼀
支	十又⺂
细	纟田
跑	⻊勹⺂
维	纟隹
异	巳廾⼀
陈	阝⼁
乱	舌乚
况	冫口⼃
忽	勿心⼂⺂
妈	女马
刀	刀⺂⼃
痛	疒甬⺂
群	尹口⼂
居	尸古
速	束辶
兄	口儿
睛	目青⼀
究	穴九⼃
斗	⺀十⼀⼁
卡	上卜⼁
甚	其乚⺂
帝	巾
喝	口日⼃
态	大丶⼂
怀	忄不⼀
局	尸𠃌
派	氵⺁
杨	木㇡⼃
谢	讠身
脑	月㐫⼂
病	疒𰀃⼃
顿	屯页⼀
治	氵厶⼁
福	礻𠮛⼁
角	角⼃⺂
旁	方
威	戊一⺂
叶	口十
京	京⼂⼀
围	囗韦⼀
园	囗元⼀⼀
皮	皮⺂
雨	雨⼀⼁⺂
号	口丂⼀
密	宀心⼃
须	彡页⼀
推	扌隹
背	北⺝⼁
河	氵可⼀
亮	几⼃
姑	女古
证	讠正⼀
费	弓⼁
汉	氵又⺂
志	士心⼂
查	木旦⼁
圣	又土⼀⼁⼀
呼	口乎⼃
讲	讠井⼀
续	纟十⺂
标	木示⼀
共	共⼀⼁⼁
尼	尸匕⼃
米	米⼂⼃
际	阝示⼀
招	扌刀⼁
超	走刀⼁
差	⺶工⼀⼁
仍	亻乃⺂
块	土⼃
莫	莫⼀⼁
游	氵𭤨⺂
药	艹纟
船	舟几⼁
网	冂乂⼃
掌	手⼃⼀
呀	口牙⼀
掉	扌⺊⼁
皇	白王⼀
玩	王元⼀
梦	林夕⼃
选	先辶
争	争⼃⺂
疑	匕矢⺂
既	旡⼀
波	氵皮
闪	门人⼃
室	宀至
料	米⺀
简	⺮门⼁
佛	亻弓⼃
堂	土⼀
索	糸
规	夫见⼁
朋	月月⼃
攻	工攵
章	音十
礼	礻乚⺂
鬼	鬼⼃⼁
春	𡗗日⼁
刘	文刂⼁
严	亚丿⼃
赶	走干⼀
睡	目垂
屋	尸至
食	食⼃
饭	饣⺁⺂
济	氵文⼃
试	讠弋⼀⼁
仙	亻山⼁
导	巳寸
参	彡⼃
沙	氵少⼁
永	丶㇉⺂
肯	止⺝⼁
环	王不⼀⼃
农	农⼂⺂
恶	亚心⼂
称	禾尔
止	止⼁⼀
初	衤刀⺂
医	匚矢⼃
敌	舌攵⼃⼀
跳	⻊儿
假	亻叚⺂
左	𠂇工⼀⼁
散	龷⺝
温	氵日⼁
继	纟米
换	扌⺈⼁
权	木又⺂
银	钅艮⺂
君	尹口⼁⺂
退	艮辶⼂
闻	门耳⼀
激	氵白⼂
画	一田⺂
较	车六⼃
烈	歹刂⼂
独	犭虫
球	王求
土	土⼀⼁⼀⼀
层	尸云
卫	卩一⼀
抱	扌勹⺂
草	艹日⼀
专	二㇉
烟	火因
余	亼朩
秋	禾火⼂
顺	川页⼀⼃
顾	厂⺋
否	不口⼁
值	亻直⼀
考	耂与⼀
冰	冫水⼁
境	土音
妹	女未⼀
恐	工几
怒	奴心⼂
伯	亻白⼃⼁
质	⺁十
艺	艹乙⺂
味	口未⼀
历	厂力
构	木勹⺂
研	石开⼀
施	𭤨也⺂
贵	𠀐贝⼁
委	禾女
渐	氵车
淡	氵火⼂
史	口乂⼃
校	木六⼃
狂	犭王⼀
馆	饣宀
板	木⺁⺂
排	扌非⼁
价	亻人⼃⼁⼁
街	彳圭⼀
宫	宀口⼁
追	丿㠯⼂
靠	告非⼁
忍	刀丶⼂⺂
普	䒑业⼁
致	至攵⼃⼀
钟	钅中⼁
娜	女𭃂⺂
耳	耳⼀⼁⼁
属	尸丿
忘	亡心⼂⺂
苏	艹力⼂
伙	亻火⼂
仅	亻又⺂
景	日京⼂
松	木公
州	川⼂
胡	古月⼃
纪	纟己⺂
印	一
赵	走乂
置	罒直⼀
投	扌殳⼃
列	歹刂⼁
隐	阝刍
缓	纟爫⼀
座	广从⼀
庄	广土⼀
幸	土𢆉⼂
副	𠮛田
充	儿⼃
守	宀寸⼀⼁
胜	月生⼃
救	求攵⼃
射	身寸⼀
齐	文⼃⼁
顶	丁页⼀
助	且力
右	𠂇口⼁
素	龶糸⺂
唐	广肀
抓	扌爪⼃
巨	匚⺂
毛	毛⼃⼀
诗	讠土⼀⼁
弄	王廾⼀⼃
防	阝方
雅	牙隹⼃
源	氵厂⼃
户	户⼂⺂
湖	氵古⼃
项	工页⼀
党	儿
压	厂土⼂
寒	𡨄⺀⼂
效	六乂⼃
奥	米
毫	毛⼃
增	土曾⼂
险	阝亼⼂
状	丬犬⼀
按	扌宀
买	乛⺀⼀
禁	林示⼀
阴	阝月
叹	口又⺂
蓝	艹𰀢⼁
察	宀⼀
承	了三⺂
省	少目
份	亻分⼃⼂
托	扌丿⼀
恩	因心⼂⺂
责	龶贝⼁
挥	扌冖⼀
洛	氵各⼃
妇	女彐⺂
牛	牛⼃⼀
习	习⺂
警	𬜠口⼃
默	黑犬⼀
岁	山夕
骑	马大⼀
股	月殳⼃
划	戈刂⼁
负	⺈贝⼁
枪	木人
梅	木𠂉
采	爫木⼀
吸	口及⼃
富	宀𠮛⼁
舞	𠂉卌
肉	内人⼃
镇	钅直⼃⼂
野	里予⺂
床	广木⼀
某	甘木
醒	酉日⼃
验	马亼
读	讠十⺂
担	扌旦⼁
毒	龶母
封	圭寸
尚	⺌冂
纳	纟内⼁
伊	亻尹⺂
营	𫇦口⼁
猛	犭子⼁
短	矢豆⼀
旧	丨日⼁
脱	月𠮦⼃
遇	日⽱⼂⺂
词	讠𠃌
坏	土不
控	扌穴⼀
田	田⼁⺂
乡	丿⼃
刺	朿刂⼁
啦	口扌⼂
孙	孑小
翻	釆田⺂
藏	艹戊⺂
虎	虍几⼃
坚	𰀡土⼀
良	丶艮⺂
柔	矛木⼀⼁⼃
眉	𠃜目⼁
伸	亻日⼁⼁
窗	穴⼃
咱	口自⼃
婚	女氏⼁
戏	又戈⼀
逃	儿⼂⺂
赛	𡨄贝⼁⺂
扬	扌㇡⼃
凡	几丶⼂
凌	冫土⼃
配	酉己
练	纟⺂
率	亠幺⼂
贝	贝⼁
宇	宀于
茶	艹人⼀
优	亻尢⼂
杰	木灬⼂
吉	吉⼀⼁
卷	龹⺋⺂
创	人⺋⼁
罢	罒去⼀
秀	禾乃⺂
归	彐⺂
哭	吅犬⼀
凤	几又⺂
陆	阝𰀁
端	立山⼀
休	亻木⼀
库	广车⼀
序	广予⺂
善	羊䒑⼁
秘	禾心⼃
拍	扌白⼃⼁
案	宀女⼀
迷	米辶⼂
震	⻗辰⼀
免	
职	耳口
洋	氵羊⼂
寻	彐寸⼀
养	羊丶⼃⼁
珠	王丿⼀
歌	可可⼃
盘	舟皿⼁
朱	丿未⼀
演	氵宀⼀
虚	虍业⼁
呆	呆⼁⺂
付	亻寸⼀
笔	⺮毛⼃
适	舌辶⼂
康	广⺕
麻	麻⼂⼀
宁	宀丁⼀
吴	口天⼀
欲	八人⼁
罪	罒非
恨	忄艮⺂
杂	九朩⼀
套	大镸⼀
骨	骨⼁
紫	此糸⺂
软	车欠⼃
蒙	𫇦一⼀⼃
弹	弓单⼂
育	⺝⼁
企	人止⼁
仿	亻方⼂
泪	氵目⼁
曲	曲⼁⺂
鱼	鱼⼃⺂
兽	丷田⼀
略	田各⼃
握	扌尸⼀
厅	厂丁⼀
厉	厂万⼀
卖	十乛
供	亻共⼀
丹	冂亠
喊	口戊⼀⼁
峰	山夂
灯	火丁⼀
绿	纟彐⼁
夏	丆目
塔	土艹⼃⼂
桌	⺊日⼀
范	落⺋⺂
限	阝艮⺂
县	且厶
讨	讠寸⼀⼁
革	革⼀
燕	廿口⼁⼀
欧	区欠⼃
临	𠂉⼂
移	禾夕⼃
洞	氵冂⼀
剧	尸古⼁
油	氵由⼁